FAWN	F AO N
PARDON	P AA R D AH N
YELLOW	Y EH L OW
FOUR	F AO R
HATH	HH AE TH
SLEEP	S L IY P
FRIEND'S	F R EH N D Z
HANGING	HH AE NG IH NG
HANGING(2)	HH AE NG G IH NG
MANSION	M AE N SH AH N
APPETITE	AE P AH T AY T
EVERMORE	EH V ER M AO R
HATE	HH EY T
FORGET	F ER G EH T
FORGET(2)	F AO R G EH T
WHOSE	HH UW Z
FEEDING	F IY D IH NG
VILE	V AY L
GRANTING	G R AE N T IH NG
GRANTING(2)	G R AE N IH NG
SWEETEST	S W IY T AH S T
PRESENTS	P R EH Z AH N T S
PRESENTS(2)	P R IY Z EH N T S
THERE'S	DH EH R Z
WHATSOEVER	W AH T S OW EH V ER
WHATSOEVER(2)	HH W AH T S OW EH V ER
UNDER	AH N D ER
LORD	L AO R D
SORRY	S AA R IY
PRIDE	P R AY D
SWAY	S W EY
WORTH	W ER TH
WONDROUS	W AH N D R AH S
DISCASED	D IH S K EY S T
DISPENSE	D IH S P EH N S
HADST	HH AE D S T
INHEARSE	IH N HH ER S
WOMEN'S	W IH M AH N Z
SHOOT	SH UW T
EVERY	EH V ER IY
EVERY(2)	EH V ERIY
EVERY(2)	EH V R IY
FOUL	F AW L
NOURISHED	N ER IH SH T
UNCERTAIN	AH N S ER T AH N
SPECIAL	S P EH SH AH L
BELIEVED	B IH L IY V D
UTTERING	AH T ER IH NG
UTTERING(2)	AH T ERIH NG
OFFEND	AH F EH N D
UNREST	AH N R EH S T
GRACED	G R EY S T
SUCCESSION	S AH K S EH SH AH N
GRACES	G R EY S IH Z
TRIUMPH	T R AY AH M F
ENJOY	EH N JH OY
CHARTER	CH AA R T ER
FORCE	F AO R S
TIRED	T AY ER D
TIRED(2)	T AYER D
AWAKE	AH W EY K
RAZED	R EY Z D
RAZED(2)	R EY Z ED
FEATHERS	F EH DH ER Z
ASSURE	AH SH UH R
TIRES	T AY ER Z
TIRES(2)	T AYER Z
CRAVE	K R EY V
PERSUADE	P ER S W EY D
QUILL	K W IH L
EVEN	IY V IH N
EVEN(2)	IYVIH N
BEATED	B IY T IH D
CAPTAIN	K AE P T AH N
HIDE	HH AY D
NE'ER	N EH R
SOLEMN	S AA L AH M
THUNDER	TH AH N D ER
BEATEN	B IY T AH N
FINGERS	F IH NG G ER Z
LIBERTY	L IH B ER T IY
CHILDREN	CH IH L D R AH N
WORSER	W ER S ER
INHERITORS	IH N HH EH R AH T ER Z
ABOVE	AH B AH V
GUILTY	G IH L T IY
MATCHETH	M AE CH IH TH
NEW	N UW
NEW(2)	N Y UW
POORLY	P UW R L IY
EVER	EH V ER
TOLD	T OW L D
DEEMED	D IY M D
MERCHANDIZED	M AH R CH AH N D AY Z D
SINKS	S IH NG K S
JOIN	JH OY N
NEVER	N EH V ER
HERE	HH IY R
HERD	HH ER D
BECK	B EH K
SWEET'ST	S W IY T S T
PURSUIT	P ER S UW T
ACTIVE	AE K T IH V
SPIES	S P AY Z
EFFECTUALLY	IH F EH K CH AH W AH L IY
DRY	D R AY
RESTY	R EH S T IY
SUBSTANCE	S AH B S T AH N S
GAOL	G EY AH L
LEAVES	L IY V Z
CLIMBED	K L AY M D
CREDIT	K R EH D AH T
CREDIT(2)	K R EH D IH T
SAINT	S EY N T
SMOKE	S M OW K
PERMIT	P ER M IH T
BETTERED	B EH T ER D
MISTAKE	M IH S T EY K
SETTLED	S EH T AH L D
POLITIC	P AA L AH T IH K
GOLDEN	G OW L D AH N
SWEARING	S W EH R IH NG
DIVIDE	D IH V AY D
MOTLEY	M AA T L IY
SORROWS	S AA R OW Z
PATIENCE	P EY SH AH N S
STERN	S T ER N
GLANCE	G L AE N S
LIGHT'S	L AY T S
PLOT	P L AA T
BUDDING	B AH D IH NG
WOULD	W UH D
RECURED	R IY S Y ER D
WORLD'S	W ER L D Z
JUNES	JH UW N Z
MUSIC	M Y UW Z IH K
THEREFORE	DH EH R F AO R
SURVIVE	S ER V AY V
GILDING	G IH L D IH NG
TELL	T EH L
BREATHE	B R IY DH
LEESE	L IY S
UNBLESS	AH N B L EH S
HOLY	HH OW L IY
WARY	W EH R IY
WARY(2)	W EHRIY
BRINGS	B R IH NG Z
MUSE	M Y UW Z
HEREIN	HH IH R IH N
GRIEF	G R IY F
GLASS	G L AE S
WARM	W AO R M
EXCELLENT	EH K S AH L AH N T
ROBBING	R AA B IH NG
WARD	W AO R D
HOLD	HH OW L D
STRIVING	S T R AY V IH NG
MUST	M AH S T
ME	M IY
LOCKED	L AA K T
ROOM	R UW M
ERR	EH R
ERR(2)	ER
RIGHTS	R AY T S
WORK	W ER K
ECLIPSE	IH K L IH P S
ECLIPSE(2)	AH K L IH P S
ECLIPSE(3)	IY K L IH P S
ROOF	R UW F
ROOF(2)	R UH F
MEADOWS	M EH D OW Z
ERE	EH R
LEAPED	L EH P T
LEAPED(2)	L IY P T
REVENUES	R EH V AH N UW Z
REVENUES(2)	R EH V AH N Y UW Z
MY	M AY
EXAMPLE	IH G Z AE M P AH L
LODGED	L AA JH D
PHRASE	F R EY Z
SUBTLETIES	S AH T AH L T IY Z
FRESHER	F R EH SH ER
WANE	W EY N
UNJUST	AH N JH AH S T
HONEY	HH AH N IY
FOIST	F OY S T
KINGDOMS	K IH NG D AH M Z
RESPOSE	R EY Z P OW Z
TIMES	T AY M Z
WORSE	W ER S
CEREMONY	S EH R AH M OW N IY
CONSUM'ST	K AA N S AH M S T
GUSTS	G AH S T S
PROVIDE	P R AH V AY D
DIGNIFIES	D IH G N AH F AY Z
TRAVEL	T R AE V AH L
INDIRECTLY	IH N D ER EH K T L IY
FEATURE	F IY CH ER
WIGHTS	W AY T S
FAR	F AA R
HOT	HH AA T
WRITERS	R AY T ER Z
ANSWER	AE N S ER
GATE	G EY T
DIGNIFIED	D IH G N AH F AY D
BLANKS	B L AE NG K S
BEAUTY	B Y UW T IY
AFTER	AE F T ER
WRONG	R AO NG
LAY	L EY
LAP	L AE P
WRONK	R AO NG K
THIRD	TH ER D
RUD'ST	R AH D S T
REVOLT	R IH V OW L T
REVOLT(2)	R IY V OW L T
GREET	G R IY T
PURGING	P ER JH IH NG
WINK	W IH NG K
MAINTAIN	M EY N T EY N
HASTE	HH EY S T
KEEPS	K IY P S
ALACK	AH L AE K
WOULDST	W OW L D S T
WIND	W AY N D
WIND(2)	W IH N D
DETERMINATE	D IH T ER M AH N EY T
COUPLEMENT	K AH P AH L M AH N T
UNTOLD	AH N T OW L D
OFFICE	AO F AH S
CONSENT	K AH N S EH N T
OVER	OW V ER
PROFANED	P R OW F EY N D
SICKLY	S IH K L IY
FORTIFY	F AO R T IH F AY
GHASTLY	G AE S T L IY
STRANGLE	S T R AE NG G AH L
BESTOW'ST	B IH S T OW S T
WROUGHT	R AO T
BEFORE	B IH F AO R
BEFORE(2)	B IY F AO R
BETTER	B EH T ER
FADE	F EY D
CARVE	K AA R V
HIDDEN	HH IH D AH N
SAVOUR	S AE V AH R
THEN	DH EH N
THEM	DH EH M
THEM(2)	DH AH M
BLOTS	B L AA T S
ENRICH	EH N R IH CH
ENRICH(2)	IH N R IH CH
THEE	DH IY
TRUTH'S	T R UW TH S
BREAK	B R EY K
WINTER'S	W IH N T ER Z
DISEASED	D IH Z IY Z D
THEY	DH EY
GLAZED	G L EY Z D
GLAZED(2)	G L EY Z ED
ONE	W AH N
ONE(2)	HH W AH N
SILVER	S IH L V ER
PRIZE	P R AY Z
SHADOWS	SH AE D OW Z
RHETORIC	R EH T ER IH K
BRIGHTNESS	B R AY T N AH S
SLAVERY	S L EY V ER IY
ROCKS	R AA K S
HERALD	HH EH R AH L D
VICTORIES	V IH K T ER IY Z
VICTORIES(2)	V IH K T R IY Z
NEEDING	N IY D IH NG
EACH	IY CH
WANTONLY	W AO N T AH N L IY
WANTONLY(2)	W AA N T AH N L IY
DULNESS	D AH L N AH S
WENT	W EH N T
SIDE	S AY D
LUCK	L AH K
WOES	W OW Z
CONCORD	K AA N K AO R D
CONCORD(2)	K AA N K ER D
'WILL'	W IH L
TAUGHT	T AO T
FORGOT	F ER G AA T
FORGOT(2)	F AO R G AA T
MISPRISION	M IH S P R IH ZH AH N
WHIT	W IH T
WHIT(2)	HH W IH T
TRUANT	T R UW AH N T
ARRAY	ER EY
BORNE	B AO R N
CONTEND	K AH N T EH N D
LARGE	L AA R JH
DECREE	D IH K R IY
VADE	V EY D
SANG	S AE NG
GOD	G AA D
FORTY	F AO R T IY
RUN'ST	R AH N S T
CONTENT	K AA N T EH N T
CONTENT(2)	K AH N T EH N T
RE	R EY
RE(2)	R IY
LAID	L EY D
HEAVENLY	HH EH V AH N L IY
HEAVENLY(2)	HH EHVAH N L IY
GOT	G AA T
MARIGOLD	M EH R AH G OW L D
FORTH	F AO R TH
PRIZING	P R AY Z IH NG
ASSURED	AH SH UH R D
ASSURED(2)	AH SH UH R ED
FADETH	F EY D IH TH
HANG	HH AE NG
DECEIVED	D IH S IY V D
ETERNAL	IH T ER N AH L
ETERNAL(2)	IY T ER N AH L
GIVEN	G IH V AH N
GIVEN(2)	G IH V IH N
GIVEN(3)	G IHVIH N
FREE	F R IY
MOURNING	M AO R N IH NG
MISTAKING	M IH S T EY K IH NG
BESTOW	B IH S T OW
WHEREUPON	W EH R AH P AA N
WHEREUPON(2)	HH W EH R AH P AA N
EVIL	IY V AH L
CROWNED	K R AW N D
CROWNED(2)	K R AW N ED
MISTRESS	M IH S T R AH S
KNIT	N IH T
WANTONNESS	W AO N T AH N AH S
RECEIV'ST	R AH S IY V S T
CREATED	K R IY EY T AH D
CREATED(2)	K R IY EY T IH D
DAYS	D EY Z
SUE	S UW
BEARS	B EH R Z
RENEW	R IH N UW
TEMPTING	T EH M P T IH NG
UNKNOWN	AH N N OW N
POTIONS	P OW SH AH N Z
LOUD	L AW D
RUINATE	R UW AH N AH T
USER	Y UW Z ER
SEPARABLE	S EH P ER AH B AH L
UNTUTORED	AH N T UW T ER D
ALREADY	AO L R EH D IY
ALREADY(2)	AO R EH D IY
CROWNING	K R AW N IH NG
HEARSAY	HH IY R S EY
'GREEING	G R IY AH NG
RANK	R AE NG K
HEARING	HH IY R IH NG
JEALOUS	JH EH L AH S
FEATURED	F IY CH ER D
ANOTHER	AH N AH DH ER
SOBER	S OW B ER
FILCHING	F IH L CH IH NG
EXCHEQUER	EH K S CH EH K ER
USURER	Y UW ZH ER ER
TOP	T AA P
TOP(2)	T AO P
HAWKS	HH AO K S
MILLIONED	M IH L Y AH N D
MASTER	M AE S T ER
TOO	T UW
DWELL	D W EH L
BITTER	B IH T ER
SAITH	S EY TH
BROILS	B R OY L Z
GRIEFS	G R IY F S
TOOK	T UH K
WISDOM	W IH Z D AH M
WARDROBE	W AO R D R OW B
YOUTH'S	Y UW TH S
CHARACTER	K EH R IH K T ER
BEGINS	B IH G IH N Z
DISTANCE	D IH S T AH N S
HERE'S	HH IH R Z
COWARD	K AW ER D
MOTHER'S	M AH DH ER Z
BITTERNESS	B IH T ER N AH S
IDLY	AY D L IY
MATTER	M AE T ER
IDLE	AY D AH L
TITLES	T AY T AH L Z
FLAME	F L EY M
FRIEND	F R EH N D
DESERVING	D IH Z ER V IH NG
ASKANCE	AH S K AE N S
KNIGHTS	N AY T S
BEARD	B IH R D
POWERS	P AWER Z
FASHION	F AE SH AH N
SEES	S IY Z
HUE	HH Y UW
MIND'S	M AY N D Z
MODERN	M AA D ER N
MIND	M AY N D
MINE	M AY N
SPENT	S P EH N T
MANNER	M AE N ER
AMISS	AH M IH S
BEWAILED	B IH W EY L D
BEWAILED(2)	B IH W EY L ED
DESERV'ST	D AH S AH R V S T
CHURL	CH AH R L
SEEM	S IY M
SEEK	S IY K
TELLS	T EH L Z
CONTENTS	K AA N T EH N T S
CONTENTS(2)	K AH N T EH N T S
PRAISING	P R EY Z IH NG
STRENGTH	S T R EH NG K TH
STRENGTH(2)	S T R EH NG TH
NECK	N EH K
SNOW	S N OW
SOUND	S AW N D
CHEST	CH EH S T
SUBJECTS	S AH B JH IH K T S
SUBJECTS(2)	S AH B JH EH K T S
SUBJECTS(3)	S AH B JH EH K S
LAUGHED	L AE F T
PILGRIMAGE	P IH L G R AH M AH JH
PILGRIMAGE(2)	P IH L G R AH M IH JH
RIDER	R AY D ER
AGGRAVATE	AE G R AH V EY T
MAIDEN	M EY D AH N
THOUGH	DH OW
OBJECT	AA B JH EH K T
OBJECT(2)	AH B JH EH K T
DIAL	D AY AH L
DIAL(2)	D AY L
JUSTIFY	JH AH S T AH F AY
DULLING	D AH L IH NG
ERRORS	EH R ER Z
ASHES	AE SH IH Z
DISARMED	D IH S AA R M D
GRAVE	G R EY V
SHALT	SH AE L T
CONSTANCY	K AA N S T AH N S IY
CONSUMED	K AH N S UW M D
FLOW	F L OW
BREATHES	B R IY DH Z
STEELED	S T IY L D
POINTS	P OY N T S
BREATHED	B R IY DH D
WRECKED	R EH K T
FITTED	F IH T AH D
FITTED(2)	F IH T IH D
RESERVE	R IH Z ER V
RESERVE(2)	R IY Z ER V
WILD	W AY L D
RENEWED	R IH N UW D
RENEWED(2)	R IY N UW D
BAIT	B EY T
OATHS	OW DH Z
OATHS(2)	OW TH S
ENJOYER	EH N JH OY ER
ENDING	EH N D IH NG
POISON	P OY Z AH N
EARTH	ER TH
BAIL	B EY L
ENJOYED	EH N JH OY D
BEARER	B EH R ER
TOUCHES	T AH CH AH Z
TOUCHES(2)	T AH CH IH Z
COPY	K AA P IY
PROPOSED	P R AH P OW Z D
SPITE	S P AY T
HERSELF	HH ER S EH L F
CUPID	K Y UW P IH D
BLISS	B L IH S
TOUCHED	T AH CH T
RICH	R IH CH
PURSUING	P ER S UW IH NG
MEND	M EH N D
'THOU	TH UW
BORROWED	B AA R OW D
DO	D UW
BLENCHES	B L EH N CH AH Z
FORSWORN	F AO R S W AO R N
'I	IY
KINDLING	K IH N D L IH NG
STOP	S T AA P
PERCEIVE	P ER S IY V
LEISURE	L EH ZH ER
LEISURE(2)	L IY ZH ER
RAIMENT	R EY M AH N T
GORED	G AO R D
BOOTLESS	B UW T L AH S
SPIRIT	S P IH R AH T
SPIRIT(2)	S P IH R IH T
SPIRIT(3)	S P IHRIH T
DESPITE	D IH S P AY T
REPORT	R IY P AO R T
REPORT(2)	R IH P AO R T
SATURN	S AE T ER N
SEEMLY	S IY M L IY
RUNS	R AH N Z
INCREASING	IH N K R IY S IH NG
BAR	B AA R
EXCHANGED	IH K S CH EY N JH D
BESEEM	B IH S IY M
THRUSTS	TH R AH S T S
DOTING	D OW T IH NG
TWICE	T W AY S
EYELIDS	AY L IH D Z
ESTEEMING	IH S T IY M IH NG
HASTEN	HH EY S AH N
STEAL	S T IY L
FARTHER	F AA R DH ER
UNPROVIDENT	AH N P R AH V AY D AH N T
PENANCE	P EH N AH N S
WOND'RING	W AA N D R AH NG
UNRESPECTED	AH N R IH S P EH K T IH D
FAIR	F EH R
HABIT	HH AE B AH T
IMITATE	IH M AH T EY T
PROCLAIMS	P R OW K L EY M Z
DEPENDS	D IH P EH N D Z
CORRUPT	K ER AH P T
BEST	B EH S T
SUBJECT	S AH B JH EH K T
SUBJECT(2)	S AH B JH IH K T
SAID	S EH D
TEMPTATION	T EH M T EY SH AH N
BETT'RING	B EH T R AH NG
AWAY	AH W EY
SAIL	S EY L
BIER	B IY R
MADDING	M AE D IH NG
MUD	M AH D
SCORE	S K AO R
FINGER	F IH NG G ER
PEBBLED	P EH B AH L D
SCORN	S K AO R N
DRAWN	D R AO N
ENLIGHTEN	EH N L AY T AH N
PRESERVE	P R AH Z ER V
PRESERVE(2)	P R IH Z ER V
PRESERVE(3)	P R IY Z ER V
WARRIOR	W AO R IY ER
WARRIOR(2)	W AO R Y ER
WE	W IY
MEN	M EH N
TERMS	T ER M Z
PARALLELS	P EH R AH L EH L Z
NATURE	N EY CH ER
WEAK	W IY K
IGNORANCE	IH G N ER AH N S
AUTHORIZING	AO TH ER AY Z IH NG
DISDAINETH	D IH S D EY N IH TH
WEAR	W EH R
DIEST	D AY AH S T
NEWS	N UW Z
NEWS(2)	N Y UW Z
DEBT	D EH T
TEMPESTS	T EH M P AH S T S
PITY	P IH T IY
FOES	F OW Z
GODDESS	G AA D AH S
ACCIDENT	AE K S AH D AH N T
DISDAIN	D IH S D EY N
FAULT	F AO L T
ILL	IH L
AGAINST	AH G EH N S T
AGAINST(2)	AH G EY N S T
BRAG	B R AE G
RECEIVES	R AH S IY V Z
RECEIVES(2)	R IH S IY V Z
RECEIVES(3)	R IY S IY V Z
FACES	F EY S AH Z
FACES(2)	F EY S IH Z
EXCEEDS	IH K S IY D Z
EXPENSE	IH K S P EH N S
GROANS	G R OW N Z
ASKED	AE S K T
ASKED(2)	AE S T
SUGGEST	S AH JH EH S T
VEXED	V EH K S T
HONOURING	AA N ER IH NG
BURTHEN	B AH R TH AH N
HEIGHT	HH AY T
HERS	HH ER Z
PRONE	P R OW N
OBLIVIOUS	AH B L IH V IY AH S
TRUST	T R AH S T
HEALS	HH IY L Z
SPEAK	S P IY K
YELLOWED	Y EH L OW D
UNHAPPILY	AH N HH AE P AH L IY
PUTS	P UH T S
EAGER	IY G ER
CONDEMNED	K AH N D EH M D
THREE	TH R IY
BEEN	B IH N
BEEN(2)	B AH N
PARTICULARS	P ER T IH K Y AH L ER Z
TWAIN	T W EY N
MUCH	M AH CH
INTEREST	IH N T AH R EH S T
INCERTAINTY	IH N S ER T AH N T IY
PRIVILEGE	P R IH V IH L IH JH
VERMILION	V ER M IH L Y AH N
LOVELY	L AH V L IY
THRICE	TH R AY S
IDOL	AY D AH L
THREW	TH R UW
LIFE	L AY F
BRAV'RY	B R AE V R IY
EASY	IY Z IY
ERRED	EH R D
DRUGS	D R AH G Z
MALADIES	M AE L AH D IY Z
DECREPIT	D AH K R EH P IH T
DOTE	D OW T
CHILD	CH AY L D
CATCH	K AE CH
DOTH	D AO TH
ERST	AH R S T
GRACIOUS	G R EY SH AH S
PHYSICIAN	F AH Z IH SH AH N
EAST	IY S T
AIR	EH R
LESSER	L EH S ER
UGLY	AH G L IY
NEAR	N IH R
SUPPOSE	S AH P OW Z
AID	EY D
VOICE	V OY S
WEAKENS	W IY K AH N Z
PLAYED	P L EY D
IS	IH Z
IT	IH T
DEFEATED	D IH F IY T AH D
DEFEATED(2)	D IH F IY T IH D
SHAME	SH EY M
SPLENDOUR	S P L EH N D AH R
WATCHING	W AA CH IH NG
IN	IH N
BOUNTEOUS	B AW N T IYAH S
IF	IH F
GROWN	G R OW N
WOOING	W UW IH NG
MEMORIAL	M AH M AO R IY AH L
AWAKES	AH W EY K S
COOLS	K UW L Z
PATENT	P AE T AH N T
THINGS	TH IH NG Z
MAKE	M EY K
WOUND	W AW N D
WOUND(2)	W UW N D
LORDS'	L AO R D Z
BESIDE	B IH S AY D
BESIDE(2)	B IY S AY D
BOSOMS	B UH Z AH M Z
PATIENT	P EY SH AH N T
TH'	T YY CH
SEVERAL	S EH V ER AH L
SEVERAL(2)	S EH V ERAH L
GROWS	G R OW Z
ENTITLED	EH N T AY T AH L D
LUSTY	L AH S T IY
FAIRLY	F EH R L IY
TOPS	T AA P S
RAIN	R EY N
HAND	HH AE N D
DELIGHT	D IH L AY T
SUPPOSING	S AH P OW Z IH NG
DARK	D AA R K
BEQUEST	B IH K W EH S T
BLAMED	B L EY M D
THOUGHTS	TH AO T S
CENSURES	S EH N CH ER Z
KEPT	K EH P T
KEPT(2)	K AE P T
THY	DH AY
SINGLENESS	S IH NG G AH L N AH S
SWEETNESS	S W IY T N AH S
POSSESSED	P AH Z EH S T
HUMBLE	HH AH M B AH L
INHERIT	IH N HH EH R AH T
OCEAN	OW SH AH N
RAGGED	R AE G AH D
FULNESS	F UH L N AH S
GREATEST	G R EY T AH S T
INCAPABLE	IH N K EY P AH B AH L
MOTHER	M AH DH ER
HEARTS	HH AA R T S
THE	DH AH
THE(2)	DH IY
CURE	K Y UH R
YOURS	Y UH R Z
YOURS(2)	Y AO R Z
YOURS(3)	Y ER Z
LEFT	L EH F T
REEKS	R IY K S
JUST	JH AH S T
JUST(2)	JH IH S T
WASTEFUL	W EY S T F AH L
YEA	Y EY
POET'S	P OW AH T S
UNFAIR	AH N F EH R
UNFAIR(2)	AO N F EH R
REPOSE	R IY P OW Z
VERSES	V ER S IH Z
MAKETH	M EY K IH TH
THANKS	TH AE NG K S
SWEARS	S W EH R Z
PROGNOSTICATE	P R AA G N AA S T AH K EY T
PLIGHT	P L AY T
YET	Y EH T
SUCCEEDING	S AH K S IY D IH NG
VICES	V AY S AH Z
VICES(2)	V AY S IH Z
ADDING	AE D IH NG
DEARER	D IH R ER
COMPEERS	K AH M P IH ER Z
STRAINS	S T R EY N Z
HAD	HH AE D
COUNTED	K AW N T IH D
PRESAGERS	P R EH S IH JH ER Z
ALCHEMY	AE L K AH M IY
BELONGS	B IH L AO NG Z
BELOVED	B IH L AH V D
BELOVED(2)	B IH L AH V AH D
PRISON	P R IH Z AH N
HAP	HH AE P
PITIFUL	P IH T AH F AH L
SAVE	S EY V
GAVE	G EY V
OTHERS'	AH DH ER Z
DIGNITY	D IH G N AH T IY
SPACIOUS	S P EY SH AH S
REVIEWEST	R IY V Y UW AH S T
BIRTH	B ER TH
WANTING	W AA N T IH NG
WANTING(2)	W AA N IH NG
SHADOW	SH AE D OW
DREAMS	D R IY M Z
PICTURE'S	P IH K CH ER Z
DESIRE	D IH Z AYER
BROUGHT	B R AO T
APPEARING	AH P IH R IH NG
FEED'ST	F IY D S T
GIFT	G IH F T
VILEST	V IH L AH S T
OFFICES	AO F AH S AH Z
OFFICES(2)	AO F AH S IH Z
NIGHT	N AY T
HUNG	HH AH NG
ANTIQUE	AE N T IY K
RIGHT	R AY T
OLD	OW L D
FLATTER	F L AE T ER
WAR'S	W AO R Z
DEAF	D EH F
DEAD	D EH D
BORN	B AO R N
DEAR	D IH R
ALTERED	AO L T ER D
BORE	B AO R
GUESS	G EH S
CREEP	K R IY P
ENEMIES	EH N AH M IY Z
FOR	F AO R
FOR(2)	F ER
FOR(3)	F R ER
PURPLE	P ER P AH L
BOSOM'S	B UH Z AH M Z
REHEARSE	R IY HH ER S
COMMENTS	K AA M EH N T S
FOE	F OW
DENIED	D IH N AY D
BOLD	B OW L D
BURN	B ER N
DIVINING	D AH V AY N IH NG
SHIFTING	SH IH F T IH NG
LOSING	L UW Z IH NG
TAKER	T EY K ER
PEEP	P IY P
DISDAINS	D IH S D EY N Z
SHAKEN	SH EY K AH N
PROCEED	P R AH S IY D
PROCEED(2)	P R OW S IY D
PROCEED(3)	P ER S IY D
THEIRS	DH EH R Z
CORAL	K AO R AH L
HAPLY	HH AE P L IY
FRAILER	F R EY L ER
O	OW
COSTS	K AA S T S
COSTS(2)	K AO S T S
DESPAIR	D IH S P EH R
PLUS	P L AH S
FELT	F EH L T
CHERISH	CH EH R IH SH
COMMIT	K AH M IH T
LACKED	L AE K T
BATH	B AE TH
RAISED	R EY Z D
FAINT	F EY N T
PRESENCE	P R EH Z AH N S
CIVIL	S IH V AH L
PAYS	P EY Z
NOUGHT	N AO T
BOUND	B AW N D
SON	S AH N
DOWN	D AW N
LIES	L AY Z
REFINED	R AH F AY N D
REFINED(2)	R IH F AY N D
REFINED(3)	R IH F AY N ED
POUR'ST	P AH R S T
METHODS	M EH TH AH D Z
STRANGELY	S T R EY N JH L IY
DESPISED	D IH S P AY Z D
JEALOUSY	JH EH L AH S IY
SOVEREIGN	S AA V R AH N
FIGHT	F AY T
VIRGIN	V ER JH IH N
WAY	W EY
CALL	K AO L
WAS	W AA Z
WAR	W AO R
HAPPY	HH AE P IY
HEAD	HH EH D
FARING	F EH R IY NG
FORM	F AO R M
STATUTE	S T AE CH UW T
CROWN	K R AW N
BECOMING	B IH K AH M IH NG
FORGETFUL	F AO R G EH T F AH L
FORGETFUL(2)	F ER G EH T F AH L
FORE	F AO R
BACK	B AE K
HEINOUS	HH EY N AH S
PRICKED	P R IH K T
HEAT	HH IY T
HEAR	HH IY R
ODOURS	OW D ER S
LEARNED	L ER N D
LEARNED(2)	L ER N IH D
ASTONISHED	AH S T AA N IH SH T
BLINDNESS	B L AY N D N AH S
REMOVED	R IY M UW V D
TRUE	T R UW
DEEPEST	D IY P AH S T
ABSENT	AE B S AH N T
LILIES	L IH L IY Z
CAPTIVE	K AE P T IH V
EXTREMITY	EH K S T R EH M AH T IY
FOR'T	F AO R T
BIDS	B IH D Z
UNTIL	AH N T IH L
CRYSTAL	K R IH S T AH L
UNFATHERED	AH N F AA DH ER D
ADORE	AH D AO R
ANEW	AH N UW
ANEW(2)	AH N Y UW
ENGRAFT	EH N G R AE F T
BIDE	B AY D
LATCH	L AE CH
TRIM	T R IH M
DISGRACE	D IH S G R EY S
ORNAMENTS	AO R N AH M AH N T S
FURY	F Y UH R IY
SINFUL	S IH N F AH L
BEAUTY'S	B Y UW T IY Z
HUNGRY	HH AH NG G R IY
HUSWIFE	HH AH S W AY F
SOMETIME	S AH M T AY M
SUBSIST	S AH B S IH S T
SHINES	SH AY N Z
FACE	F EY S
INJURIOUS	IH N JH UH R IY AH S
INJURIOUS(2)	IH N JH UH R IYAH S
POSTING	P OW S T IH NG
WILLINGLY	W IH L IH NG L IY
LOOKED	L UH K T
INFLAMING	IH N F L EY M IH NG
DYING	D AY IH NG
NO	N OW
EXCEL	IH K S EH L
LOV'ST	L AA V S T
ACTOR	AE K T ER
THRIFTLESS	TH R IH F T L AH S
DESPISING	D IH S P AY Z IH NG
FALSELY	F AO L S L IY
PAPERS	P EY P ER Z
TIE	T AY
VANISHED	V AE N IH SH T
SMELL	S M EH L
ETERNITY	IH T ER N AH T IY
ETERNITY(2)	IY T ER N AH T IY
PICTURE	P IH K CH ER
INTEND	IH N T EH N D
PHOENIX	F IY N IH K S
PYRAMIDS	P IH R AH M IH D Z
DIES	D AY Z
WELCOME	W EH L K AH M
JOURNEY	JH ER N IY
REIGN	R EY N
ROLLING	R OW L IH NG
PIERCED	P IH R S T
SEEING	S IY IH NG
DIED	D AY D
WRACKFUL	R AE K F AH L
LONGER	L AO NG G ER
BLUSHING	B L AH SH IH NG
DAILY	D EY L IY
CHEATER	CH IY T ER
TEETH	T IY TH
DIAN'S	D AY AH N Z
LAWS	L AO Z
RESTORED	R IH S T AO R D
SONGS	S AO NG Z
WHOEVER	HH UW EH V ER
VARYING	V EH R IY IH NG
PERCEIV'ST	P AH R S IY V S T
SOULS	S OW L Z
INVENT	IH N V EH N T
ENGRAFTED	EH N G R AE F T IH D
LEADS	L IY D Z
CONTINUAL	K AH N T IH N Y UW AH L
CONTINUAL(2)	K AH N T IH N Y UWAH L
SLANDERED	S L AE N D ER D
IDOLATRY	AY D AA L AH T R IY
ABUNDANT	AH B AH N D AH N T
RETENTION	R IY T EH N SH AH N
MOUNTED	M AW N T AH D
MOUNTED(2)	M AW N T IH D
MOUNTED(3)	M AW N IH D
PRAISES	P R EY Z IH Z
FATHER	F AA DH ER
CONFOUNDS	K AH N F AW N D Z
VEX	V EH K S
ANSWERED	AE N S ER D
CHARGE	CH AA R JH
PRAISED	P R EY Z D
SUFFERED	S AH F ER D
ADDETH	AE D IH TH
FURROWS	F ER OW Z
ABUNDANCE	AH B AH N D AH N S
STRUMPETED	S T R AH M P EH T IH D
STRING	S T R IH NG
ADVANTAGE	AE D V AE N T IH JH
DRUDGE	D R AH JH
FLEECE	F L IY S
VOTARY	V OW T EH R IY
MOURN	M AO R N
ADVISED	AE D V AY Z D
ADVISED(2)	AH D V AY Z D
WORD	W ER D
TROUBLE	T R AH B AH L
FEEBLE	F IY B AH L
COOL	K UW L
SOUL'S	S OW L Z
PERCEIVED	P ER S IY V D
CLOUDS	K L AW D Z
LEVEL	L EH V AH L
DID	D IH D
DIE	D AY
DIG	D IH G
BEST'	B EH S T
LEAVE	L IY V
EXCELLENCE	EH K S AH L AH N S
BURNED	B ER N D
QUICK	K W IH K
PREVENT	P R IH V EH N T
PREVENT(2)	P R IY V EH N T
BRAVE	B R EY V
SAYS	S EH Z
SAYS(2)	S IH Z
FEARING	F IH R IH NG
OFFENDER'S	AH F EH N D ER Z
MINION	M IH N Y AH N
SIGH	S AY
WHEREFORE	W EHER F OW R
COST	K AA S T
COST(2)	K AO S T
SHOW'ST	SH OW S T
RUN	R AH N
FEAR	F IH R
INDIGEST	IH N D AY JH EH S T
INDIGEST(2)	IH N D AH JH EH S T
HYMN	HH IH M
FLEET'ST	F L IY T S T
CURSE	K ER S
APPEAR	AH P IH R
ASSISTANCE	AH S IH S T AH N S
CONTRACTED	K AA N T R AE K T AH D
FAVOUR	F EY V ER
PLEASED	P L IY Z D
SUSPECT	S AH S P EH K T
GOES	G OW Z
PINE	P AY N
APPEAL	AH P IY L
FILLED	F IH L D
APRIL'S	EY P R AH L Z
PRESCRIPTIONS	P R AH S K R IH P SH AH N Z
WAIL	W EY L
HONOUR	AA N ER
CLERK	K L ER K
WATER	W AO T ER
ENTERTAIN	EH N T ER T EY N
ENTERTAIN(2)	EH N ER T EY N
ALONE	AH L OW N
APPEARS	AH P IH R Z
CHANGE	CH EY N JH
BLUNTER	B L AH N T ER
BOY	B OY
BOAST	B OW S T
ROOT	R UW T
WHEREVER	W EH R EH V ER
WHEREVER(2)	HH W EH R EH V ER
BOW	B AW
BOW(2)	B OW
SPHERES	S F IH R Z
SHOOK	SH UH K
RECOUNTING	R IH K AW N T IH NG
RECOUNTING(2)	R IY K AW N T IH NG
STAINED	S T EY N D
LOVE	L AH V
HUMOUR	HH Y UW M ER
TEMPTETH	T EH M P T IH TH
BLOODY	B L AH D IY
WITHAL	W IH TH AO L
BETRAYING	B IH T R EY IH NG
SURMOUNT	S ER M AW N T
SWALLOWED	S W AA L OW D
SUFF'RING	S AH F R AH NG
O'ERWORN	AHAH R W AH R N
VOICES	V OY S AH Z
VOICES(2)	V OY S IH Z
WEALTH	W EH L TH
PROVE	P R UW V
SAKE	S EY K
CONFOUNDED	K AH N F AW N D IH D
ANGRY	AE NG G R IY
GIVE	G IH V
ONLY	OW N L IY
BATT'RING	B AE T R AH NG
WRONGS	R AO NG Z
LIVE	L AY V
LIVE(2)	L IH V
WOOD	W UH D
PREY	P R EY
MEMORY	M EH M ER IY
SCOPE	S K OW P
LOVING	L AH V IH NG
LOVE'S	L AH V Z
FIERCE	F IH R S
RIOT	R AY AH T
SESSIONS	S EH SH AH N Z
TOWERS	T AW ER Z
TOWERS(2)	T AWER Z
NEGLECTED	N AH G L EH K T AH D
NEGLECTED(2)	N IH G L EH K T IH D
ACCEPTABLE	AE K S EH P T AH B AH L
ACCEPTABLE(2)	AH K S EH P T AH B AH L
STRENGTH'S	S T R EH NG K TH S
DROWN	D R AW N
EVERYWHERE	EH V R IY W EH R
EVERYWHERE(2)	EH V R IY HH W EH R
VIRTUE	V ER CH UW
ROBE	R OW B
EPITAPH	EH P AH T AE F
FLY	F L AY
IMPAIR	IH M P EH R
SHEDS	SH EH D Z
CAR	K AA R
SOUL	S OW L
PURGE	P ER JH
HARDEST	HH AA R D AH S T
SOUR	S AW ER
SOUR(2)	S AW R
CAN	K AE N
CAN(2)	K AH N
GROWING	G R OW IH NG
MAKING	M EY K IH NG
PREVENT'ST	P R IY V EH N T S T
DECEASED	D IH S IY S T
DECEASED(2)	D IH S IY S ET
BREEDS	B R IY D Z
HEART	HH AA R T
DEDICATED	D EH D AH K EY T AH D
SERVANT'S	S ER V AH N TS
WANT	W AA N T
WANT(2)	W AO N T
FIGURE	F IH G Y ER
PREDICT	P R IH D IH K T
PREDICT(2)	P R IY D IH K T
ARISE	ER AY Z
DISTILLATION	D IH S T AH L EY SH AH N
HEARD	HH ER D
CRITIC	K R IH T IH K
PURITY	P Y UH R AH T IY
PURITY(2)	P Y UH R IH T IY
HIDES	HH AY D Z
MAK'ST	M AE K S T
PROVOKE	P R AH V OW K
STOLE	S T OW L
BEREFT	B ER EH F T
CHURLS	CH AH R L Z
WINTER	W IH N T ER
DRESS	D R EH S
DIVIDED	D IH V AY D IH D
UNDIVIDED	AH N D AH V AY D IH D
CLOAK	K L OW K
TROPHIES	T R OW F IY Z
LOUR'ST	L AH R S T
WRITE	R AY T
TILL	T IH L
SWORD	S AO R D
HUSBANDRY	HH AH Z B AH N D R IY
SWORN	S W AO R N
EYE'S	AY Z
MAP	M AE P
MAR	M AA R
MAY	M EY
FED	F EH D
SPOT	S P AA T
SIREN	S AY R AH N
MAD	M AE D
DATE	D EY T
END	EH N D
HATETH	HH EY T IH TH
FLOURISH	F L ER IH SH
GROW	G R OW
MAN	M AE N
TEMPERATE	T EH M P R AH T
TEMPERATE(2)	T EH M P ER AH T
REMEMBER	R IH M EH M B ER
REMEMBER(2)	R IY M EH M B ER
LIQUID	L IH K W AH D
LIQUID(2)	L IH K W IH D
CANDLES	K AE N D AH L Z
RATHER	R AE DH ER
RATHER(2)	R AH DH ER
SO	S OW
SILENCE	S AY L AH N S
DECEIVE	D IH S IY V
THORNS	TH AO R N Z
TALL	T AO L
INCREASE	IH N K R IY S
FORCED	F AO R S T
SERVING	S ER V IH NG
RECEIVEST	R IH S IY V AH S T
INDEED	IH N D IY D
FORFEIT	F AO R F IH T
WISHING	W IH SH IH NG
YEARS	Y IH R Z
COURSE	K AO R S
PITCH	P IH CH
COLD	K OW L D
STILL	S T IH L
BIRDS	B ER D Z
TRIFLE	T R AY F AH L
LIMBS	L IH M Z
DERIVE	D ER AY V
THANK	TH AE NG K
ACKNOWLEDGE	AE K N AA L IH JH
MUSES	M Y UW Z AH Z
MUSES(2)	M Y UW Z IH Z
CHIPS	CH IH P S
INFERIOR	IH N F IH R IY ER
CURLS	K ER L Z
MAID	M EY D
TILLAGE	T IH L AE JH
PLAY'ST	P L EY S T
POLICY	P AA L AH S IY
STOL'N	S T AA L N
MAIN	M EY N
INTO	IH N T UW
INTO(2)	IH N T AH
CORRESPONDENCE	K AO R AH S P AA N D AH N S
CLOSURE	K L OW ZH ER
TRUEST	T R UW IH S T
EQUIPAGE	IH K W IH P IH JH
THEREBY	DH EH R B AY
SOONER	S UW N ER
DELIGHTED	D IH L AY T AH D
DELIGHTED(2)	D IH L AY T IH D
RECORDS	R AH K AO R D Z
RECORDS(2)	R EH K ER D Z
RECORDS(3)	R IH K AO R D Z
HALF	HH AE F
NOT	N AA T
NOW	N AW
TWILIGHT	T W AY L AY T
KILLED	K IH L D
NOR	N AO R
WONT	W OW N T
TERM	T ER M
NAME	N EY M
SERVANT	S ER V AH N T
DROP	D R AA P
DROP(2)	D R AO P
BREACH	B R IY CH
VEINS	V EY N Z
ORPHANS	AO R F AH N Z
SURFEIT	S ER F AH T
ANOTHER'S	AH N AH DH ER Z
RECEIPT	R IH S IY T
RECEIPT(2)	R IY S IY T
RICHLY	R IH CH L IY
FEVER	F IY V ER
FAREWELL	F EH R W EH L
SEETING	S IY T AH NG
YEAR	Y IH R
HYMNS	HH IH M Z
TUNED	T UW N D
LIVING	L IH V IH NG
SHOWN	SH OW N
FOLLOWED	F AA L OW D
MOUTHS	M AW DH Z
SPACE	S P EY S
PROFIT	P R AA F AH T
PROFIT(2)	P R AA F IH T
CONFINE	K AH N F AY N
ABIDE	AH B AY D
LOOKING	L UH K IH NG
BOUNDLESS	B AW N D L AH S
GRECIAN	G R IY SH AH N
RECEIVING	R AH S IY V IH NG
RECEIVING(2)	R IH S IY V IH NG
RECEIVING(3)	R IY S IY V IH NG
CORRECT	K ER EH K T
SHOWS	SH OW Z
WORTHINESS	W ER DH IY N IH S
SIEGE	S IY JH
CARS	K AA R Z
CARS(2)	K AA Z
QUITE	K W AY T
REBEL	R EH B AH L
REBEL(2)	R IH B EH L
PLEA	P L IY
FEEL'ST	F IY L S T
CARE	K EH R
ADVANCE	AH D V AE N S
AGE'S	EY JH IH Z
EMBASSAGE	IH M B EY S IH JH
GOEST	G OW AH S T
CONTENTED	K AH N T EH N T AH D
CONTENTED(2)	K AH N T EH N T IH D
WAND'REST	W AA N D R AH S T
HONEST	AA N AH S T
MOTION	M OW SH AH N
THING	TH IH NG
THINE	DH AY N
PLACE	P L EY S
RECOMPENSE	R EH K AH M P EH N S
SUFFERANCE	S AH F ER AH N S
WIDOW	W IH D OW
WARNING	W AO R N IH NG
THINK	TH IH NG K
FREQUENT	F R IY K W AH N T
FREQUENT(2)	F R IY K W EH N T
FIRST	F ER S T
BLIND	B L AY N D
MAYST	M EY S T
WAVES	W EY V Z
TEACHEST	T IY CH AH S T
NATIVITY	N AH T IH V AH T IY
CONSECRATE	K AA N S AH K R EY T
LONG	L AO NG
DIRECTLY	D ER EH K T L IY
DIRECTLY(2)	D IY R EH K L IY
DIRECTLY(3)	D AY R EH K L IY
DIRECTLY(4)	D IH R EH K L IY
HABITATION	HH AE B AH T EY SH AH N
CARRY	K AE R IY
CARRY(2)	K EH R IY
SOUNDS	S AW N D Z
SOUNDS(2)	S AW N Z
TAME	T EY M
OPEN	OW P AH N
OPEN(2)	OWPAH N
AFFORDS	AH F AO R D Z
MILLIONS	M IH L Y AH N Z
INTERCHANGE	IH N T ER CH EY N JH
INTERCHANGE(2)	IH N ER CH EY N JH
LITTLE	L IH T AH L
CHECKED	CH EH K T
SILENT	S AY L AH N T
BREED	B R IY D
COMPLEXIONED	K AH M P L EH K SH AH N D
FIERY	F AY ER IY
BOUNTY	B AW N T IY
WHITE	W AY T
WHITE(2)	HH W AY T
TIGER'S	T AY G ER Z
SPEAKING	S P IY K IH NG
GIVES	G IH V Z
GAUDY	G AO D IY
EYES	AY Z
POMP	P AA M P
BLAZON	B L EY Z AH N
THAT	DH AE T
THAT(2)	DH AH T
BRAINS	B R EY N Z
MEN'S	M EH N Z
PROVING	P R UW V IH NG
HURT	HH ER T
ALAS	AH L AE S
EYED	AY D
GIRDED	G ER D IH D
REPROVING	R IY P R UW V IH NG
FLOWERS	F L AW ER Z
FLOWERS(2)	F L AWER Z
THAN	DH AE N
THAN(2)	DH AH N
STICK'ST	S T IH K S T
WIDE	W AY D
WERT	W ER T
REQUIRE	R IY K W AY ER
REQUIRE(2)	R IY K W AY R
REQUIRE(3)	R IH K W AY ER
FOLLY	F AA L IY
TRANSFERRED	T R AE N S F ER D
WERE	W ER
CARCANET	K AA R K AH N AH T
AND	AH N D
AND(2)	AE N D
DESPERATE	D EH S P R IH T
DESPERATE(2)	D EH S P ER IH T
ANGEL	EY N JH AH L
SLAY	S L EY
CORRECTION	K ER EH K SH AH N
CONFESSED	K AH N F EH S T
TURNED	T ER N D
ARGUMENT	AA R G Y AH M AH N T
JEWELS	JH UW AH L Z
JEWELS(2)	JH UW L Z
SAD	S AE D
ENTOMBED	EH N T UW M D
SAY	S EY
PERFUMES	P ER F Y UW M Z
BURIED	B EH R IY D
BURIED(2)	B EH R IY ED
FOILED	F OY L D
ANGER	AE NG G ER
SAP	S AE P
PRY	P R AY
ANY	EH N IY
JACKS	JH AE K S
SPORT	S P AO R T
DEFACED	D IH F EY S T
MOURNERS	M AO R N ER Z
ASIDE	AH S AY D
NOTE	N OW T
WRETCH	R EH CH
TAKE	T EY K
RESEMBLING	R IH Z EH M B AH L IH NG
RESEMBLING(2)	R IY Z EH M B AH L IH NG
RESEMBLING(3)	R IY Z EH M B L IH NG
GREEN	G R IY N
BLUNT	B L AH N T
FLATTERED	F L AE T ER D
URGE	ER JH
BEGIN	B IH G IH N
SURE	SH UH R
PAIN	P EY N
BUSY	B IH Z IY
TALLIES	T AE L IY Z
KNEW	N UW
KNEW(2)	N Y UW
CLEARER	K L IH R ER
PAID	P EY D
REMOVER	R IH M UW V ER
UNKINDNESS	AH N K AY N D N AH S
STAINETH	S T EY N IH TH
FLATTERER	F L AE T ER ER
TRACT	T R AE K T
PALATE	P AE L AH T
PALATE(2)	P AE L IH T
WINTERS	W IH N T ER Z
GARMENTS	G AA R M AH N T S
PROUD	P R AW D
TRAVEL'S	T R AE V AH L Z
WING	W IH NG
PERFECT'ST	P AH R F EH K T S T
SUNSET	S AH N S EH T
AMIS	AE M IH S
GLUTTON	G L AH T AH N
PERFUMED	P ER F Y UW M D
SOUREST	S AW ER AH S T
BURIEST	B EH R IY AH S T
BURIEST(2)	B EH R IYAH S T
SHOP	SH AA P
SHOW	SH OW
CHEAP	CH IY P
MERIT	M EH R AH T
TRESPASS	T R EH S P AE S
TRESPASS(2)	T R EH S P AH S
BRIGHT	B R AY T
SAYING	S EY IH NG
GROUND	G R AW N D
SLOW	S L OW
WOOS	W UW Z
UNKIND	AH N K AY N D
STORMY	S T AO R M IY
TITLE	T AY T AH L
TREASURE	T R EH ZH ER
ROBS	R AA B Z
WRITTEN	R IH T AH N
CRIME	K R AY M
TEARS	T EH R Z
TEARS(2)	T IH R Z
GOING	G OW IH NG
GOING(2)	G OW IH N
BLACK	B L AE K
PARTAKE	P AA R T EY K
STAIN	S T EY N
WILFULLY	W IH L F AH L IY
HINDMOST	HH AY N D M OW S T
GET	G EH T
GET(2)	G IH T
'TIS	T IH Z
LIMBECKS	L IH M B AH K S
TRULY	T R UW L IY
CANNOT	K AE N AA T
CANNOT(2)	K AH N AA T
RASED	R EY Z D
NEARLY	N IH R L IY
DYE	D AY
PRIME	P R AY M
SELDOM	S EH L D AH M
YIELD	Y IY L D
MORNING	M AO R N IH NG
NAKED	N EY K AH D
MILES	M AY L Z
MILES(2)	M AY AH L Z
WHERE	W EH R
WHERE(2)	HH W EH R
HUSBAND	HH AH Z B AH N D
MONARCH'S	M AA N AA R K S
COMMITTED	K AH M IH T IH D
UP	AH P
FORTUNE'S	F AO R CH AH N Z
FORTUNE'S(2)	F AO R CH UW N Z
ASLEEP	AH S L IY P
EXPIATE	EH K S P IY EY T
SUCCESSIVE	S AH K S EH S IH V
SEAL	S IY L
SALUTATION	S AE L Y AH T EY SH AH N
RUINED	R UW AH N D
RUINED(2)	R UW IH N D
PRAYERS	P R EH R Z
PRAYERS(2)	P R EY ER Z
PUREST	P Y UH R AH S T
WONDER	W AH N D ER
INVOKED	IH N V OW K T
COMPOUNDS	K AA M P AW N D Z
COMPOUNDS(2)	K AH M P AW N D Z
CROOKED	K R UH K AH D
REVIEW	R IY V Y UW
AMEN	EY M EH N
AMEN(2)	AA M EH N
ORNAMENT	AO R N AH M AH N T
BEHIND	B IH HH AY N D
DEPARTEST	D IY P AA R T AH S T
COMPLEXION	K AH M P L EH K SH AH N
SABLE	S EY B AH L
IMPORT	IH M P AO R T
ENJOYS	EH N JH OY Z
PRESAGE	P R EH S IH JH
UNTAINTED	AH N T EY N T IH D
FORSAKE	F AO R S EY K
LAYS	L EY Z
DISCLOSES	D IH S K L OW Z IH Z
PLUCK	P L AH K
BLAME	B L EY M
FAULTS	F AO L T S
COUNTENANCE	K AW N T AH N AH N S
REIGNS	R EY N Z
PROFITLESS	P R AA F AH T L AH S
COME	K AH M
GRIEVED	G R IY V D
DATES	D EY T S
MANY	M EH N IY
REGION	R IY JH AH N
QUIET	K W AY AH T
TRESSES	T R EH S IH Z
AWARDS	AH W AO R D Z
SEA'S	S IY Z
DUTY	D UW T IY
DUTY(2)	D Y UW T IY
AMONG	AH M AH NG
UNTHRIFTS	AH N TH R IH F T S
MADNESS	M AE D N AH S
SPOIL	S P OY L
UNTHRIFTY	AH N TH R IH F T IY
LACE	L EY S
SWERVING	S W ER V IH NG
DISPATCH	D IH S P AE CH
SLAIN	S L EY N
STRETCHED	S T R EH CH T
LEARNING	L ER N IH NG
PROVED	P R UW V D
HOUNDS	HH AW N D Z
BOAT	B OW T
ARTS	AA R T S
WEST	W EH S T
DROSS	D R AO S
MARK	M AA R K
BREATH	B R EH TH
SUBSCRIBES	S AH B S K R AY B Z
SELF'S	S EH L F S
MARS	M AA R Z
INFORMER	IH N F AO R M ER
FICKLE	F IH K AH L
STRAYING	S T R EY IH NG
ROBBED	R AA B D
THOUSAND	TH AW Z AH N D
THOUSAND(2)	TH AW Z AH N
BLESSING	B L EH S IH NG
NOBLER	N OW B L ER
WAKE	W EY K
EXTERNAL	IH K S T ER N AH L
MASONRY	M EY S AH N R IY
CAREFUL	K EH R F AH L
DECEIVEST	D IH S IY V AH S T
THOSE	DH OW Z
CASE	K EY S
CLEARS	K L IH R Z
PROFANE	P R OW F EY N
SCARLET	S K AA R L AH T
THESE	DH IY Z
SHEAVES	SH IY V Z
COMPILE	K AH M P AY L
CAST	K AE S T
PROVES	P R UW V Z
CANCELLED	K AE N S AH L D
SITUATION	S IH CH UW EY SH AH N
ENDURED	EH N D Y UH R D
ENDURED(2)	IH N D UH R D
FOOL	F UW L
ENDOWED	EH N D AW D
BROW	B R AW
GLUTTONING	G L AH T AH N IH NG
MIDDLE	M IH D AH L
LIMPING	L IH M P IH NG
RETURN	R IH T ER N
RETURN(2)	R IY T ER N
FAME	F EY M
DIFFERENT	D IH F ER AH N T
DIFFERENT(2)	D IH F R AH N T
HARSH	HH AA R SH
TYRANTS'	T AY R AH N T S
DOCTOR	D AA K T ER
DOCTOR(2)	D AO K T ER
PAY	P EY
SAME	S EY M
CHECK	CH EH K
SHIFTS	SH IH F T S
DISTILLED	D IH S T IH L D
FIGURES	F IH G Y ER Z
LADIES	L EY D IY Z
'TRUTH	T R AH TH
WIRES	W AY ER Z
WIRES(2)	W AY R Z
FACULTY	F AE K AH L T IY
SICKNESS	S IH K N AH S
TYRANNOUS	T AH R AE N AH S
DEFY	D IH F AY
WEED	W IY D
DWELLERS	D W EH L ER Z
FRUIT	F R UW T
SCORNED	S K AO R N D
CONQUERED	K AA NG K ER D
EXTERN	EH K S T ER N
CHANGING	CH EY N JH IH NG
WEEP	W IY P
SLANDER'S	S L AE N D ER Z
VOWED	V AW D
VANTAGE	V AE N T AH JH
VANTAGE(2)	V AE N T IH JH
THRONED	TH R OW N D
THRONED(2)	TH R OW N ED
RANDOM	R AE N D AH M
VACANT	V EY K AH N T
WITHOUT	W IH TH AW T
WITHOUT(2)	W IH DH AW T
RELIEF	R IH L IY F
RELIEF(2)	R IY L IY F
CHARGED	CH AA R JH D
DISTILLS	D IH S T IH L Z
SUMMER	S AH M ER
RANSOMS	R AE N S AH M Z
BEING	B IY IH NG
BEING(2)	B IYIH NG
WHEN	W EH N
WHEN(2)	HH W EH N
WHEN(3)	W IH N
WHEN(4)	HH W IH N
COMPOUND	K AA M P AW N D
COMPOUND(2)	K AH M P AW N D
SHAMEFULLY	SH EY M F AH L IY
REST	R EH S T
IMPRINT	IH M P R IH N T
BARENESS	B EH R N AH S
CEASE	S IY S
DISPERSE	D IH S P ER S
ASPECT	AE S P EH K T
TOUCH	T AH CH
SPEED	S P IY D
GUIDES	G AY D Z
AFTERWARDS	AE F T ER W ER D Z
BLOW	B L OW
BLOT	B L AA T
UNWOOED	AH N W UW D
CHARACTERED	K AE R IH K T ER D
THINKING	TH IH NG K IH NG
ROSE	R OW Z
SEEMS	S IY M Z
SUMMER'S	S AH M ER Z
SUMMERS'	S AH M ER Z
VERSE	V ER S
SUPPRESSED	S AH P R EH S T
WORTHIER	W ER DH IY ER
WORTHIER(2)	W ER DH IYER
THROW	TH R OW
DULLY	D AH L IY
BOND	B AA N D
STRUCK	S T R AH K
KINGDOM	K IH NG D AH M
FROWN	F R AW N
KILLS	K IH L Z
READ	R EH D
READ(2)	R IY D
OFFENCE	AH F EH N S
SUMS	S AH M Z
DART	D AA R T
BASEST	B EY S AH S T
TRAFFIC	T R AE F IH K
CONFINED	K AH N F AY N D
WORLD	W ER L D
REAP	R IY P
DARE	D EH R
ACQUAINTED	AH K W EY N T IH D
ACQUAINTED(2)	AH K W EY N IH D
FORTUNE	F AO R CH AH N
FORTUNE(2)	F AO R CH UW N
ACHIEVE	AH CH IY V
MIRACLE	M IH R AH K AH L
BENEFIT	B EH N AH F IH T
WRETCH'S	R EH CH IX Z
EITHER	IY DH ER
EITHER(2)	AY DH ER
ROBBERY	R AA B ER IY
OFFENDERS	AH F EH N D ER Z
WARRANTISE	W AO R AH N T AY Z
TOMBED	T UW M D
FULFIL	F UH L F AH L
FALSEHOOD	F AE L S HH UH D
KINGS	K IH NG Z
IMAGES	IH M AH JH AH Z
IMAGES(2)	IH M IH JH IH Z
DIVINE	D IH V AY N
THINKS	TH IH NG K S
GROSS	G R OW S
COURSES	K AO R S AH Z
COURSES(2)	K AO R S IH Z
NOON	N UW N
LEND	L EH N D
STOPS	S T AA P S
MOON	M UW N
FORGOING	F AO R G OW IH NG
EXPRESSING	IH K S P R EH S IH NG
KNIFE	N AY F
DESTROYS	D IH S T R OY Z
SHORN	SH AO R N
POWER	P AW ER
POWER(2)	P AWER
SECONDS	S EH K AH N D Z
BLEST	B L EH S T
STRAINED	S T R EY N D
OLIVES	AA L IH V Z
FORGETFULNESS	F AO R G EH T F AH L N AH S
BROKEN	B R OW K AH N
BROKEN(2)	B R OWKAH N
ASSEMBLE	AH S EH M B AH L
FEEDS	F IY D Z
ON	AA N
ON(2)	AO N
STONE	S T OW N
SUBDUED	S AH B D UW D
ZEALOUS	Z EH L AH S
OF	AH V
CHOIRS	K W AY R Z
FEIL	F IY L
WHENCE	W EH N S
WHENCE(2)	HH W EH N S
FELL	F EH L
WOLF	W UH L F
STAND	S T AE N D
ACT	AE K T
MIXED	M IH K S T
BEAR'ST	B AH AA R S T
OR	AO R
OR(2)	ER
IMITATED	IH M AH T EY T IH D
WIDOWED	W IH D OW D
BURNING	B ER N IH NG
PUT'ST	P AH T S T
DISTEMPERED	D IH S T EH M P ER D
IMAGE	IH M AH JH
IMAGE(2)	IH M IH JH
BLESSED	B L EH S T
BLESSED(2)	B L EH S ET
RISING	R AY Z IH NG
LIVELY	L AY V L IY
DREAMING	D R IY M IH NG
BLESSES	B L EH S IH Z
YOUR	Y AO R
YOUR(2)	Y UH R
BUDS	B AH D Z
OATHS'	OW DH Z
OATHS'(2)	OW TH S
FAST	F AE S T
PREPARE	P R IY P EH R
THERE	DH EH R
DISPOSED	D IH S P OW Z D
SIDES	S AY D Z
STEALTH	S T EH L TH
GAZE	G EY Z
SEASONS'	S IY Z AH N Z
STARS	S T AA R Z
JAWS	JH AO Z
VALLEY	V AE L IY
BETTERING	B EH T ER IH NG
GROAN	G R OW N
ENOUGH	IH N AH F
ENOUGH(2)	IY N AH F
YOU'	Y UW
PETTY	P EH T IY
DYER'S	D AY ER Z
DELAYED	D IH L EY D
STRIKES	S T R AY K S
MEETNESS	M IY T N AH S
SUFFERS	S AH F ER Z
WITH	W IH DH
WITH(2)	W IH TH
HAPPIES	HH AE P IY Z
ABUSED	AH B Y UW Z D
APPLYING	AH P L AY IH NG
RAGE	R EY JH
NIGGARDING	N IH G AA R D AH NG
IMPUTE	IH M P Y UW T
ABUSES	AH B Y UW S IH Z
ABUSES(2)	AH B Y UW Z IH Z
STRONGLY	S T R AO NG L IY
GONE	G AO N
INTENTS	IH N T EH N T S
CELESTIAL	S AH L EH S CH AH L
FIST	F IH S T
TASTE	T EY S T
AH	AA
ACCENTS	AE K S EH N T S
STEALING	S T IY L IH NG
AM	AE M
AM(2)	EY EH M
DEEP	D IY P
AN	AE N
AN(2)	AH N
TOILED	T OY L D
EXCUSING	IH K S K Y UW Z IH NG
DEEM	D IY M
CARVED	K AA R V D
WALKS	W AO K S
AY	EY
AY(2)	AY
SPENDS	S P EH N D Z
SPENDS(2)	S P EH N Z
FILL	F IH L
AGAIN	AH G EH N
AGAIN(2)	AH G EY N
PROUDLY	P R AW D L IY
JUDGMENT'S	JH AH JH M AH N TS
DESERVE	D IH Z ER V
HELEN'S	HH EH L IH N Z
REPENT	R IH P EH N T
INCERTAINTIES	IH N S ER T AH N T IY Z
ROSES	R OW Z IH Z
WAND'RING	W AA N D R IH NG
YOU	Y UW
ABYSM	AE B AH Z AH M
POOR	P UW R
TIME	T AY M
GIFTS	G IH F T S
GIFTS(2)	G IH F S
FLOWER	F L AW ER
FLOWER(2)	F L AWER
WRESTING	R EH S T IH NG
SUITED	S UW T AH D
SUITED(2)	S UW T IH D
BRASS	B R AE S
SEQUENT	S IY K W AH N T
BUILDING	B IH L D IH NG
BACKWARD	B AE K W ER D
REMOTE	R IH M OW T
REMOTE(2)	R IY M OW T
CALLS	K AO L Z
WIFE	W AY F
LIFE'S	L AY F S
DYED	D AY D
REPAY	R IY P EY
HUGELY	HH Y UW JH L IY
TREASON	T R IY Z AH N
APPAREL	AH P AE R AH L
TANNED	T AE N D
UNSET	AH N S EH T
ALL	AO L
CONSIDER	K AH N S IH D ER
POINTING	P OY N T IH NG
SUNS	S AH N Z
FORBIDDEN	F AO R B IH D AH N
FORBIDDEN(2)	F ER R B IH D AH N
LACK	L AE K
NEIGH	N EY
WORMS	W ER M Z
IMPORTUNE	IH M P ER T UW N
SEALS	S IY L Z
SUNK	S AH NG K
'GAINST	G EY N S T
FORGED	F AO R JH D
FORGED(2)	F AO R JH ED
WELFARE	W EH L F EH R
FOLLOW	F AA L OW
MEDITATION	M EH D AH T EY SH AH N
FASTER	F AE S T ER
RELIGIOUS	R IH L IH JH AH S
RELIGIOUS(2)	R IY L IH JH AH S
GILD'ST	JH IH L D S T
WAKENED	W EY K AH N D
WANTON	W AO N T AH N
WANTON(2)	W AA N T AH N
HOMAGE	AA M AH JH
HOMAGE(2)	HH AA M AH JH
SPARKLING	S P AA R K L IH NG
SPARKLING(2)	S P AA R K AH L IH NG
FORMER	F AO R M ER
KEEP'ST	K IY P S T
TO	T UW
TO(2)	T IH
TO(3)	T AH
PRESENT	P R EH Z AH N T
PRESENT(2)	P R IY Z EH N T
PRESENT(3)	P ER Z EH N T
DRESSING	D R EH S IH NG
NURSETH	N ER S IH TH
HIDEOUS	HH IH D IY AH S
WEEKS	W IY K S
PAYING	P EY IH NG
WOMAN	W UH M AH N
RETURNED	R IH T ER N D
RETURNED(2)	R IY T ER N D
SONG	S AO NG
VERY	V EH R IY
SAVED	S EY V D
COLOURED	K AH L ER D
OBLATION	AA B L EY SH AH N
MEDICINE	M EH D AH S AH N
WORST	W ER S T
MINDED	M AY N D AH D
MINDED(2)	M AY N D IH D
FALL	F AO L
FALL(2)	F AA L
HEMS	HH EH M Z
DIFFERENCE	D IH F ER AH N S
DIFFERENCE(2)	D IH F R AH N S
VOUCHSAFE	V AW CH S EY F
HEAVEN	HH EH V AH N
HEAVEN(2)	HH EHVAH N
LIST	L IH S T
SILVERED	S IH L V ER D
FEARFUL	F IH R F AH L
SMALL	S M AO L
T'	T IY
TENDER	T EH N D ER
I'LL	AY L
QUICKER	K W IH K ER
TEN	T EH N
OUTWORN	AW T W OW R N
PAST	P AE S T
WINDS	W IH N D Z
WINDS(2)	W AY N D Z
INVENTION	IH N V EH N SH AH N
PERSPECTIVE	P ER S P EH K T IH V
PASS	P AE S
BEMOANED	B IH M OW N D
AFFABLE	AE F AH B AH L
BEFRIENDS	B IH F R EH N D Z
CRESTS	K R EH S T S
CREATURES	K R IY CH ER Z
CONSCIENCE	K AA N SH AH N S
GAZERS	G EY Z ER Z
WHAT	W AH T
WHAT(2)	HH W AH T
DEFENCE	D IH F EH N S
DARKNESS	D AA R K N AH S
SWEETLY	S W IY T L IY
CLOCK	K L AA K
SUN	S AH N
SUM	S AH M
BRIEF	B R IY F
PREVAILED	P R IH V EY L D
PREVAILED(2)	P R IY V EY L D
FOISON	F OWIY Z AO N
NURSE	N ER S
SHUN	SH AH N
PUBLIC	P AH B L IH K
WOMB	W UW M
DWELLS	D W EH L Z
FULL	F UH L
RANGED	R EY N JH D
ANSWERS	AE N S ER Z
REVENGE	R IY V EH N JH
HOURS	AW ER Z
HOURS(2)	AW R Z
ENSCONCE	IH N S K AA N S
EXCESS	EH K S EH S
EXCESS(2)	IH K S EH S
HAST	HH AE S T
DEPEND	D IH P EH N D
STRONG	S T R AO NG
RESPECT	R IH S P EH K T
RESPECT(2)	R IY S P EH K T
ENMITY	EH N M AH T IY
ENMITY(2)	EH N M IH T IY
LOSSES	L AO S AH Z
LOSSES(2)	L AO S IH Z
DEARTHS	D ER TH S
REASON	R IY Z AH N
SIMPLY	S IH M P L IY
ACTION	AE K SH AH N
STEEPY	S T IY P IY
EXTANT	EH K S T AH N T
ONWARDS	AA N W ER D Z
DAY'S	D EY Z
DEPART	D IH P AA R T
IMPIETY	IH M P AY AH T IY
TENDERED	T EH N D ER D
FEARFULLY	F IH ER F AH L IY
LION'S	L AY AH N Z
ESTIMATE	EH S T AH M AH T
ESTIMATE(2)	EH S T AH M EY T
UNTHRIFT	AH N TH R IH F T
EYE	AY
TAKES	T EY K S
CHERUBINS	CH AH R UW B AH N Z
CONTAINS	K AH N T EY N Z
TWO	T UW
PEARL	P ER L
MORN	M AO R N
SOIL	S OY L
TAKEN	T EY K AH N
INJURY	IH N JH ER IY
MORE	M AO R
HORSES	HH AO R S AH Z
HORSES(2)	HH AO R S IH Z
WRETCHED	R EH CH IH D
UNLEARNED	AH N L ER N D
UNLEARNED(2)	AH N L ER N ED
KNOWS	N OW Z
DELVES	D EH L V Z
OW'ST	OW S T
FOREGONE	F AO R G AO N
SPOILS	S P OY L Z
WOEFUL	W OW F AH L
EXCUSE	IH K S K Y UW S
EXCUSE(2)	IH K S K Y UW Z
LAMENESS	L EY M N AH S
CONTROLLING	K AH N T R OW L IH NG
BROKE	B R OW K
GRAVEN	G R EY V AH N
KNOWN	N OW N
DOOM	D UW M
GLAD	G L AE D
CUNNING	K AH N IH NG
COMMANDED	K AH M AE N D IH D
LUST	L AH S T
NONE	N AH N
HOUR	AW ER
HOUR(2)	AW R
BESIDES	B IH S AY D Z
BESIDES(2)	B IY S AY D Z
REMAIN	R IH M EY N
REMAIN(2)	R IY M EY N
NINE	N AY N
LEARN	L ER N
MARBLE	M AA R B AH L
HISTORY	HH IH S T ER IY
HISTORY(2)	HH IH S T R IY
BEAUTIFUL	B Y UW T AH F AH L
COMPARE	K AH M P EH R
ATTAINTED	AH T EY N T EH D
VISAGE	V IH Z AH JH
TRIAL	T R AY AH L
TRIAL(2)	T R AY L
SHARE	SH EH R
CONSPIRE	K AH N S P AY ER
THIEVISH	TH IY V IH SH
NUMBERS	N AH M B ER Z
PURCHASED	P ER CH AH S T
SENSE	S EH N S
SHARP	SH AA R P
ALLEGE	AH L EH JH
HUGE	HH Y UW JH
HUGE(2)	Y UW JH
NEEDS	N IY D Z
DRAINED	D R EY N D
SICKEN	S IH K AH N
NEEDY	N IY D IY
'THUS	TH AH Z
COMFORT	K AH M F ER T
CHOPT	CH AA P T
ADDER'S	AE D ER Z
GLOWING	G L OW IH NG
HEART'S	HH AA R T S
SACRED	S EY K R AH D
SACRED(2)	S EY K R IH D
CLOYING	K L OY IH NG
CREATURE	K R IY CH ER
SIMPLICITY	S IH M P L IH S AH T IY
SIMPLICITY(2)	S IH M P L IH S IH T IY
RUDE	R UW D
DISGRACED	D IH S G R EY S T
MENDED	M EH N D IH D
BLOOD	B L AH D
COMING	K AH M IH NG
MONSTERS	M AA N S T ER Z
REPLETE	R IY P L IY T
A	AH
A(2)	EY
REFUSE	R AH F Y UW Z
REFUSE(2)	R EH F Y UW Z
REFUSE(3)	R IH F Y UW Z
SHORT	SH AO R T
RESEMBLE	R IH Z EH M B AH L
RESEMBLE(2)	R IY Z EH M B AH L
SHADY	SH EY D IY
REGISTER	R EH JH IH S T ER
PRESENT'ST	P R IY S EH N T S T
FOOTED	F UH T IH D
SHORE	SH AO R
SHADE	SH EY D
PERJURED	P ER JH ER D
BANKS	B AE NG K S
PLEASURE	P L EH ZH ER
GAV'ST	G AE V S T
PENURY	P EH N Y UH R IY
DREAM	D R IY M
THAT'S	DH AE T S
RECITE	R AH S AY T
HELP	HH EH L P
WINGED	W IH NG D
STAYS	S T EY Z
SOON	S UW N
DISABLED	D IH S EY B AH L D
HELD	HH EH L D
PAPER	P EY P ER
THROUGH	TH R UW
SIGNS	S AY N Z
HELL	HH EH L
SMILING	S M AY L IH NG
SUFFER	S AH F ER
SAUCY	S AO S IY
STYLE	S T AY L
PENT	P EH N T
RENDER	R EH N D ER
TERMED	T ER M D
PRAY	P R EY
INWARD	IH N W ER D
DEEDS	D IY D Z
BOSOM	B UH Z AH M
TEEMING	T IY M IH NG
FAMISHED	F AE M IH SH T
LATE	L EY T
RESORT	R IH Z AO R T
RESORT(2)	R IY Z AO R T
RESORT(3)	R IY S AO R T
ABSENCE	AE B S AH N S
STRANGE	S T R EY N JH
THREESCORE	TH R IY S K OW R
RUINING	R UW IH N IH NG
MIGHT	M AY T
ALTER	AO L T ER
CRAWLS	K R AO L Z
FORBEAR	F AO R B AE ER
FORBEAR(2)	F AO R B AEER
TUNE	T UW N
GOOD	G UH D
GOOD(2)	G IH D
TYRANTS	T AY R AH N T S
KINGLY	K IH NG L IY
SEEKING	S IY K IH NG
FOOD	F UW D
YE	Y IY
YE(2)	Y EH
SPEECHLESS	S P IY CH L AH S
WALLS	W AO L Z
NYMPHS	N IH M F S
THEREOF	DH EH R AH V
WEEDS	W IY D Z
FOOT	F UH T
HUNTED	HH AH N T AH D
HUNTED(2)	HH AH N T IH D
HUNTED(3)	HH AH N AH D
HUNTED(4)	HH AH N IH D
BREATHERS	B R IY DH ER Z
MISTRESS'	M IH S T R AH S
COMPLAIN	K AH M P L EY N
LIKENESS	L AY K N AH S
IMPRISONED	IH M P R IH Z AH N D
BENT	B EH N T
ALWAYS	AO L W EY Z
ALWAYS(2)	AO L W IY Z
TRUTHS	T R UW TH S
ELOQUENCE	EH L AH K W AH N S
TEAR	T EH R
TEAR(2)	T IH R
STOPPED	S T AA P T
TURNS	T ER N Z
FOUND	F AW N D
HEAVY	HH EH V IY
WEIGHS	W EY Z
BENDS	B EH N D Z
WEIGHT	W EY T
HOUSE	HH AW S
HARD	HH AA R D
OPPRESSED	AH P R EH S T
SURLY	S ER L IY
NATURE'S	N EY CH ER Z
BEYOND	B IH AA N D
BEYOND(2)	B IY AO N D
BEYOND(3)	B IH AO N D
ORIENT	AO R IY EH N T
TRAVELS	T R AE V AH L Z
LOVERS	L AH V ER Z
MISSED	M IH S T
SINCE	S IH N S
PUBLISH	P AH B L IH SH
ADMIRED	AH D M AY ER D
HEALTH	HH EH L TH
HILL	HH IH L
PRINT	P R IH N T
DARLING	D AA R L IH NG
ISSUE	IH SH UW
SYMPATHIZED	S IH M P AH TH AY Z D
STEWARDS	S T UW ER D Z
BOLDNESS	B OW L D N AH S
BELIED	B IH L AY D
COMMITS	K AH M IH T S
FORGIVE	F ER G IH V
FORGIVE(2)	F AO R G IH V
PLEASANT	P L EH Z AH N T
QUALIFY	K W AA L AH F AY
BASE	B EY S
IMPEACHED	IH M P IY CH T
PUT	P UH T
TEACH	T IY CH
REPROACH	R IY P R OW CH
KNOW'ST	N OW S T
BEAST	B IY S T
OWNERS	OW N ER Z
SERVICE	S ER V AH S
SERVICE(2)	S ER V IH S
WOMAN'S	W UH M AH N Z
NOTED	N OW T AH D
NOTED(2)	N OW T IH D
RONDURE	R AA N D Y AH R
PURE	P Y UH R
TWENTY	T W EH N T IY
CORRUPTING	K ER AH P T IH NG
FEED	F IY D
GAZED	G EY Z D
SEEMING	S IY M IH NG
FORWARDS	F AO R W ER D Z
BLUSH	B L AH SH
FEEL	F IY L
NUMBER	N AH M B ER
ANTIQUITY	AE N T IH K W AH T IY
ELDER	EH L D ER
ENLARGED	EH N L AA R JH D
REVOLUTION	R EH V AH L UW SH AH N
DONE	D AH N
DEFECTS	D IY F EH K T S
DEFECTS(2)	D IH F EH K T S
SLEPT	S L EH P T
RENTS	R EH N T S
MOAN	M OW N
HORSE	HH AO R S
GUEST	G EH S T
BECOME	B IH K AH M
SWART	S W AO R T
TOGETHER	T AH G EH DH ER
SLANDERERS	S L AE N D ER ER Z
LEAST	L IY S T
HALLOWED	HH AE L OW D
SHAMED	SH EY M D
STORM	S T AO R M
ESSAYS	EH S EY Z
HUNDRED	HH AH N D R AH D
HUNDRED(2)	HH AH N D R IH D
HUNDRED(3)	HH AH N ER D
HUNDRED(4)	HH AH N D ER D
STORE	S T AO R
LEASE	L IY S
NUMBERED	N AH M B ER D
YOUNGLY	Y AH NG L IY
SELLING	S EH L IH NG
IMPERFECT	IH M P ER F IH K T
PASSED	P AE S T
LONGING	L AO NG IH NG
ADONIS	AH D AA N AH S
PART	P AA R T
BOWER	B AW ER
BELIEVE	B IH L IY V
GRACE	G R EY S
KING	K IH NG
KIND	K AY N D
GREW	G R UW
MORTALITY	M AO R T AE L AH T IY
VIAL	V AY AH L
DOUBLE	D AH B AH L
ANTICIPATE	AE N T IH S AH P EY T
MORTGAGED	M AO R G IH JH D
GREY	G R EY
SHALLOWEST	SH AE L OW AH S T
YOUTH	Y UW TH
AUTUMN	AO T AH M
DETERMINED	D IH T ER M AH N D
CONTRARY	K AA N T R EH R IY
CONTRARY(2)	K AH N T R EH R IY
SUPPOSED	S AH P OW Z D
TOWARD	T AH W AO R D
TOWARD(2)	T AO R D
RESTFUL	R EH S T F AH L
AFAR	AH F AA R
TONGUES	T AH NG Z
TRIFLES	T R AY F AH L Z
AGES	EY JH IH Z
DEFECT	D IY F EH K T
DEFECT(2)	D IH F EH K T
LIVERY	L IH V ER IY
SUBSTANTIAL	S AH B S T AE N SH AH L
ALIKE	AH L AY K
SHOWERS	SH AW ER Z
TRAVAIL	T R AH V EY L
FADING	F EY D IH NG
SENSUAL	S EH N SH AH W AH L
SENSUAL(2)	S EH N SH AHWAH L
SELL	S EH L
MOUNTAIN	M AW N T AH N
NIGHTS	N AY T S
BUILT	B IH L T
DRUNK	D R AH NG K
DANCING	D AE N S IH NG
SELF	S EH L F
ONSET	AA N S EH T
ONSET(2)	AO N S EH T
LIFTS	L IH F T S
LIP	L IH P
FINDING	F AY N D IH NG
DRINKS	D R IH NG K S
CHARY	CH AA R IY
CHARY(2)	CH AARIY
ART'S	AA R T S
'HAD	HH AE D
TOWARDS	T AH W AO R D Z
TOWARDS(2)	T AO R D Z
RECKON	R EH K AH N
DROWNS	D R AW N Z
UNSWAYED	AH N S W EY D
UNUSED	AH N Y UW Z D
UNUSED(2)	AH N Y UW Z ED
MOST	M OW S T
MOST(2)	M OW S
FANGLED	F AE NG G AH L D
OFFENCES	AH F EH N S IH Z
BLUNTING	B L AH N T IH NG
AMAZETH	AH M EY Z IH TH
NOTHING	N AH TH IH NG
SEASONS	S IY Z AH N Z
O'ERCHARGED	AHAH R CH AH R JH D
WASTES	W EY S T S
MEASURED	M EH ZH ER D
STANDS	S T AE N D Z
CHRONICLE	K R AA N IH K AH L
FEASTING	F IY S T IH NG
WINDOWS	W IH N D OW Z
BUILDED	B IH L D IH D
CLEAR	K L IH R
SOMETIMES	S AH M T AY M Z
COVER	K AH V ER
COVER(2)	K AHVER
UNBRED	AH N B R EH D
WANING	W EY N IH NG
REELETH	R IY L IH TH
BARREN	B AE R AH N
BARREN(2)	B EH R AH N
CONVERTEST	K AH N V ER T AH S T
EISEL	AY S AH L
LYING	L AY IH NG
STONES	S T OW N Z
BENDING	B EH N D IH NG
DESPISE	D IH S P AY Z
GOLD	G OW L D
GATES	G EY T S
Y'HAVE	Y HH EY V
WAILING	W EY L IH NG
FOND	F AA N D
RHYMERS	R AY M ER Z
WASTED	W EY S T AH D
WASTED(2)	W EY S T IH D
REGISTERS	R EH JH AH S T ER Z
REGISTERS(2)	R EH JH IH S T ER Z
FINE	F AY N
FIND	F AY N D
VIEWEST	V Y UW AH S T
SPORTIVE	S P OW R T IH V
GILDED	G IH L D IH D
FLATTERY	F L AE T ER IY
SHOULDST	SH OW L D S T
DESERTS	D EH Z ER T S
DESERTS(2)	D IH Z ER T S
RUIN	R UW AH N
RUIN(2)	R UW IH N
LESS	L EH S
WAITING	W EY T IH NG
VISION	V IH ZH AH N
BETRAY	B IH T R EY
BEAUTEOUS	B Y UW T IYAH S
FIEND	F IY N D
PAINTER'S	P EY N T ER Z
PAINTER'S(2)	P EY N ER Z
NIGGARD	N IH G ER D
GAINS	G EY N Z
MERCY	M ER S IY
COMPILED	K AH M P AY L D
EXPRESS	IH K S P R EH S
IMPREGNABLE	IH M P R EH G N AH B AH L
TREES	T R IY Z
REMEDY	R EH M AH D IY
HID	HH IH D
BREAST	B R EH S T
THEFT	TH EH F T
COMPASS	K AH M P AH S
SEPULCHRES	S EH P AH L K ER Z
SEND'ST	S EH N D S T
HIM	HH IH M
HIM(2)	IH M
DISTRACTION	D IH S T R AE K SH AH N
GRIEVANCES	G R IY V AH N S AH Z
GRIEVANCES(2)	G R IY V AH N S IH Z
PLEASURES	P L EH ZH ER Z
CRY	K R AY
IMPANELLED	IH M P AE N AH L D
REMOVE	R IY M UW V
AUGURS	AO G ER Z
COMMON	K AA M AH N
KILL	K IH L
POISONED	P OY Z AH N D
WRONGFULLY	R AO NG F AH L IY
BARS	B AA R Z
SET	S EH T
ART	AA R T
DECLINES	D IH K L AY N Z
JADE	JH EY D
O'ERSWAYS	OWER Z W EY Z
SEE	S IY
BARE	B EH R
ARE	AA R
ARE(2)	ER
SEA	S IY
PRESENTETH	P R EH Z AH N T IH TH
BARK	B AA R K
OUTWARD	AW T W ER D
SPIRITS	S P IH R IH T S
FORLORN	F ER L AO R N
PLEASE	P L IY Z
DROOPING	D R UW P IH NG
UNIONS	Y UW N Y AH N Z
WON	W AH N
WON(2)	W AA N
GENTLEST	JH EH N T AH L AH S T
AFFAIRS	AH F EH R Z
WOE	W OW
GUILT	G IH L T
RITE	R AY T
TIBEY	T IH B IY
THRIVE	TH R AY V
ENDURE	EH N D Y UH R
ENDURE(2)	IH N D UH R
KNOWING	N OW IH NG
CREATING	K R IY EY T IH NG
SOLD	S OW L D
SOLE	S OW L
VANISHING	V AE N IH SH IH NG
DEATH	D EH TH
ALTERS	AO L T ER Z
BOTH	B OW TH
FEELING	F IY L IH NG
LAST	L AE S T
GROUNDED	G R AW N D IH D
DESIRED	D IH Z AYER D
DESIRED(2)	D IH Z AY ER D
THOU	DH AW
ANON	AE N AH N
FORGOTTEN	F ER G AA T AH N
FORGOTTEN(2)	F AO R G AA T AH N
POVERTY	P AA V ER T IY
POSSESSETH	P AH Z EH S IH TH
APPROVE	AH P R UW V
FINDS	F AY N D Z
USEST	Y UW S AH S T
FLIES	F L AY Z
MAJESTY	M AE JH AH S T IY
POINT	P OY N T
REASONS	R IY Z AH N Z
SWEET	S W IY T
LOAN	L OW N
MANNERS	M AE N ER Z
EXCEPT	IH K S EH P T
LIKER	L AY K ER
WORTHLESS	W ER TH L AH S
DEVIL	D EH V AH L
UNWORTHINESS	AH N W ER DH IY N AH S
'SCAPED	S K EY P T
ARREST	ER EH S T
STAMP	S T AE M P
DEVOURING	D IH V AW ER IH NG
ACCEPTANCE	AE K S EH P T AH N S
ACCEPTANCE(2)	AH K S EH P T AH N S
SATIRE	S AE T AY ER
DUE	D UW
DUE(2)	D Y UW
ADULTERATE	AH D AH L T ER EY T
WHOM	HH UW M
SECRET	S IY K R AH T
SECRET(2)	S IY K R IH T
WOOD'S	W UH D Z
WAIT	W EY T
DELIGHTS	D IH L AY T S
ROSY	R OW Z IY
FIRM	F ER M
RESTING	R EH S T IH NG
LIVED	L IH V D
LIVED(2)	L AY V D
PARTLY	P AA R T L IY
GAY	G EY
'TWIXT	T W IH K S T
FIRE	F AY ER
FIRE(2)	F AY R
DIAL'S	D AY AH L Z
DIAL'S(2)	D AY L Z
OVERTHROW	OW V ER TH R OW
CONVERT	K AA N V ER T
CONVERT(2)	K AH N V ER T
ELSE	EH L S
LIVES	L IH V Z
LIVES(2)	L AY V Z
RECEIVE	R AH S IY V
RECEIVE(2)	R IH S IY V
RECEIVE(3)	R IY S IY V
MOURNFUL	M AO R N F AH L
PLANTS	P L AE N T S
UTMOST	AH T M OW S T
LOOK	L UH K
STRAIGHT	S T R EY T
ADMIRE	AE D M AY R
PACE	P EY S
WHILE	W AY L
WHILE(2)	HH W AY L
RIGOUR	R IH G AH R
INTERMIXED'	IH N T ER M IH K S T
KISSING	K IH S IH NG
ECLIPSES	IH K L IH P S IH Z
ECLIPSES(2)	IY K L IH P S IH Z
COSTLY	K AA S T L IY
COSTLY(2)	K AO S T L IY
ODOUR	OW D ER
IS'T	IH S T
CONFOUND	K AA N F AW N D
CONFOUND(2)	K AH N F AW N D
VOW	V AW
FRANTIC	F R AE N T IH K
UNPERFECT	AH N P ER F AH K T
OWES	OW Z
SEEN	S IY N
RID	R IH D
SEEST	S IY AH S T
SEEST(2)	S IYAH S T
FAIRER	F EH R ER
CHASE	CH EY S
TWOFOLD	T UW F OW L D
GRANT	G R AE N T
LENGTHS	L EH NG K TH S
LENGTHS(2)	L EH NG TH S
BRISTLY	B R IH S AH L IY
BELONG	B IH L AO NG
ENGROSSED	IH N G R OW S T
WHEREIN	W EH R IH N
WHEREIN(2)	HH W EH R IH N
DISCOURSE	D IH S K AO R S
ESTEEMED	EH S T IY M D
RUTH	R UW TH
COMPOSITION	K AA M P AH Z IH SH AH N
COVETOUS	K AH V AH T AH S
USED	Y UW Z D
USED(2)	Y UW ZE D
LIE	L AY
MOW	M OW
MOMENT	M OW M AH N T
FLOWN	F L OW N
MOVING	M UW V IH NG
PURPOSE	P ER P AH S
WRETCHCD	R EH CH D
EARLY	ER L IY
TASK	T AE S K
OLDER	OW L D ER
ACCUMULATE	AH K Y UW M Y AH L EY T
BEVEL	B EH V AH L
CHEEK	CH IY K
LOATHSOME	L OW DH S AH M
LOATHSOME(2)	L OW TH S AH M
FROWN'ST	F R OW N S T
GRIND	G R AY N D
MORROW	M AA R OW
MORROW(2)	M AO R OW
CHEER	CH IH R
EDGE	EH JH
STARVED	S T AA R V D
TOIL	T OY L
STELLED	S T EH L D
SPEND	S P EH N D
GROSSLY	G R OW S L IY
PLAGUES	P L EY G Z
PRESUME	P R IH Z UW M
SALVE	S AA V
SHAPE	SH EY P
ARIGHT	AH R AY T
INJURIES	IH N JH ER IY Z
UNTO	AH N T UW
GEMS	JH EH M Z
TABLES	T EY B AH L Z
CUT	K AH T
CUP	K AH P
HATED	HH EY T AH D
HATED(2)	HH EY T IH D
DECAYED	D IH K EY D
WEAKNESS	W IY K N AH S
HUES	HH Y UW Z
CRYING	K R AY IH NG
EITHER'S	IY DH ER Z
TONGUE'S	T AH NG Z
MARCH	M AA R CH
LACKING	L AE K IH NG
BIG	B IH G
BID	B IH D
ADVOCATE	AE D V AH K AH T
ADVOCATE(2)	AE D V AH K EY T
JUDGEMENT	JH AH JH M AH N T
REDEEM	R IH D IY M
QUEST	K W EH S T
MESSENGERS	M EH S AH N JH ER Z
DEARLY	D IH R L IY
NECESSARY	N EH S AH S EH R IY
SHARPENED	SH AA R P AH N D
GARMENTS'	G AA R M AH N T S
OUTRIGHT	AW T R AY T
INVITING	IH N V AY T IH NG
FOLLOWS	F AA L OW Z
HATE'	HH EY T
STRIFE	S T R AY F
SHAPES	SH EY P S
TRANSLATED	T R AE N Z L EY T AH D
TRANSLATED(2)	T R AE N S L EY T IH D
TRIBES	T R AY B Z
FOOLISH	F UW L IH SH
CANST	K AE N S T
WRACK	R AE K
OFTEN	AO F T AH N
OFTEN(2)	AO F AH N
WOMBS	W UW M Z
SPRING	S P R IH NG
SPRING(2)	S P ER IH NG
CREATION	K R IY EY SH AH N
SOME	S AH M
PLAY	P L EY
SIGHS	S AY Z
LIPS	L IH P S
ADDED	AE D IH D
SIGHT	S AY T
CURIOUS	K Y UH R IY AH S
CURIOUS(2)	K Y UH R IYAH S
PALE	P EY L
SAUCES	S AO S AH Z
SAUCES(2)	S AO S IH Z
DELIVERED	D IH L IH V ER D
ACQUAINTANCE	AH K W EY N T AH N S
FAIRING	F EH R IH NG
SHALL	SH AE L
OBLIVION	AH B L IH V IYAH N
BALMY	B AA M IY
PEN	P EH N
BARRENLY	B AE R AH N L IY
LARK	L AA R K
WORSHIP	W ER SH AH P
WORSHIP(2)	W ER SH IH P
BE	B IY
EATING	IY T IH NG
REMEMBERED	R IH M EH M B ER D
REMEMBERED(2)	R IY M EH M B ER D
CLAY	K L EY
SHADOW'S	SH AE D OW Z
'THIS	TH IH Z
ALOFT	AH L AO F T
RENT	R EH N T
FEE	F IY
CONCEALED	K AH N S IY L D
UNIVERSE	Y UW N AH V ER S
BY	B AY
SHINE	SH AY N
FAITH	F EY TH
DESERVED	D IH Z ER V D
WRINKLES	R IH NG K AH L Z
DESERVES	D IH Z ER V Z
AMBUSH	AE M B UH SH
HATRED	HH EY T R AH D
TENANTS	T EH N AH N T S
YOUTHFUL	Y UW TH F AH L
MISPLACED	M IH S P L EY S T
REPAIR	R IH P EH R
CONQUEST	K AA NG K W EH S T
WITHIN	W IH DH IH N
WITHIN(2)	W IH TH IH N
WARMED	W AO R M D
DEBATETH	D AH B EY T IH TH
SERVICES	S ER V AH S AH Z
SERVICES(2)	S ER V IH S IH Z
BECAUSE	B IH K AO Z
BECAUSE(2)	B IH K AH Z
BECAUSE(3)	B IH K AA Z
REMEMBRANCE	R IY M EH M B R AH N S
LESSON	L EH S AH N
SHARP'ST	SH AA R P S T
SMELLS	S M EH L Z
TORN	T AO R N
STORY	S T AO R IY
FEATURELESS	F IY CH ER L AH S
SPENDING	S P EH N D IH NG
QUESTION	K W EH S CH AH N
QUESTION(2)	K W EH SH AH N
CHIDE	CH AY D
WHERETO	W EH R T OW
SLANDERING	S L AE N D ER IH NG
SUIT	S UW T
FORWARD	F AO R W ER D
TRANSLATE	T R AE N Z L EY T
TRANSLATE(2)	T R AE N S L EY T
HIMSELF	HH IH M S EH L F
ELSEWHERE	EH L S W EH R
GOVERNS	G AH V ER N Z
GRACIOUSLY	G R EY SH AH S L IY
HEALTHFUL	HH EH L TH F AH L
FROST	F R AO S T
VOWING	V AW IH NG
AUTHORITY	AH TH AO R AH T IY
NEWER	N UW ER
FILED	F AY L D
HOPES	HH OW P S
LINE	L AY N
DULL	D AH L
USURY	Y UW ZH ER IY
USURY(2)	Y UW Z ER IY
DIRECTED	D ER EH K T AH D
DIRECTED(2)	D ER EH K T IH D
DIRECTED(3)	D AY R EH K T IH D
DIRECTED(4)	D IH R EH K T IH D
HUSH	HH AH SH
IMMURED	IH M Y AH R D
LOVER'S	L AH V ER Z
SULLIED	S AH L IY D
US	AH S
US(2)	Y UW EH S
LORDS	L AO R D Z
MATURITY	M AH CH UH R AH T IY
MATURITY(2)	M AH T Y UH R IH T IY
SLANDER	S L AE N D ER
HIED	HH AY D
CALLED	K AO L D
VASSALAGE	V AE S AH L IH JH
BELL	B EH L
SORT	S AO R T
CONSTANT	K AA N S T AH N T
BIND	B AY N D
GOODLY	G UH D L IY
WILLED	W IH L D
ALLAYED	AH L EY D
INFLUENCE	IH N F L UW AH N S
INFLUENCE(2)	IH N F L UWAH N S
RARITIES	R EH R IH T IY Z
SINGLE	S IH NG G AH L
MIGHTIER	M AY T IYER
ASSAILED	AH S EY L D
SURMISE	S ER M AY Z
RAINY	R EY N IY
SULLEN	S AH L AH N
SUNKEN	S AH NG K AH N
IMPEDIMENTS	IH M P EH D AH M AH N T S
PEACE	P IY S
FEARS	F IH R Z
DIMMED	D IH M D
AFFORD	AH F AO R D
BECOMES	B IH K AH M Z
NAY	N EY
MOCK	M AA K
PERUSAL	P ER UW Z AH L
DRAW	D R AO
ELEMENTS	EH L AH M AH N T S
CLEAN	K L IY N
BESIEGE	B IH S IY JH
BREASTS	B R EH S T S
RISE	R AY Z
WEIGH	W EY
MAKELESS	M EY K L AH S
WRINKLE	R IH NG K AH L
DESERT	D EH Z ER T
DESERT(2)	D IH Z ER T
LAND	L AE N D
HAPPIER	HH AE P IY ER
HAPPIER(2)	HH AE P IYER
EXCUSE'	IH K S K Y UW S
EXCUSE'(2)	IH K S K Y UW Z
SPEND'ST	S P EH N D S T
VICE	V AY S
AGE	EY JH
WARDS	W AO R D Z
ADMIRING	AE D M AY R IH NG
HEATS	HH IY T S
CAME	K EY M
FRESH	F R EH SH
MARVEL	M AA R V AH L
HAVING	HH AE V IH NG
ONCE	W AH N S
PARTIAL	P AA R SH AH L
WILFULNESS	W IH L F AH L N AH S
DISCONTENT	D IH S K AH N T EH N T
HIGHMOST	HH AY M OW S T
TOMBS	T UW M Z
DEFORMED'ST	D AH F AO R M AH D S T
ALIEN	EY L IY AH N
WINDY	W IH N D IY
WINDY(2)	W AY N D IY
GO	G OW
RUMINATE	R UW M IH N EY T
SEEMED	S IY M D
GRAVES	G R EY V Z
TINCTURE	T IH NG K CH ER
UPHOLD	AH P HH OW L D
RECKONED	R EH K AH N D
YOUNG	Y AH NG
SEND	S EH N D
DEBARRED	D IY B AA R D
PLEASING	P L IY Z IH NG
VIRTUOUS	V ER CH UW AH S
VIRTUOUS(2)	V ER CH UWAH S
QUEEN	K W IY N
WISHED	W IH SH T
TORTURE	T AO R CH ER
'NOW	N OW
'NOT	N AA T
CONFOUNDING	K AH N F AW N D IH NG
RHYME	R AY M
LANGUISHED	L AE NG G W IH SH T
REBUKED	R IH B Y UW K T
REBUKED(2)	R IY B Y UW K T
SCANTED	S K AE N T IH D
ACCUSE	AH K Y UW Z
TELLING	T EH L IH NG
INIQUITY	IH N IH K W IH T IY
BONDS	B AA N D Z
TRY	T R AY
EVE'S	IY V Z
RACE	R EY S
VERDICT	V ER D IH K T
BETWIXT	B IY T W IH K S T
RACK	R AE K
ALT'RING	AE L T R AH NG
CROW	K R OW
WORK'S	W ER K S
THINLY	TH IH N L IY
WAKING	W EY K IH NG
JUMP	JH AH M P
FOLD	F OW L D
ISSUELESS	IH SH UW L AH S
PLEAD	P L IY D
DECREES	D IH K R IY Z
VICTOR	V IH K T ER
GIVING	G IH V IH NG
SURETY	SH UH R AH T IY
SURETY(2)	SH UH R AHTIY
SAW	S AO
EXPRESSED	IH K S P R EH S T
MAN'S	M AE N Z
ROTTEN	R AA T AH N
BIRD	B ER D
BODY	B AA D IY
MELANCHOLY	M EH L AH N K AA L IY
CHOSE	CH OW Z
GATHERED	G AE DH ER D
SINS	S IH N Z
NIMBLE	N IH M B AH L
SCYTHE	S IH TH
SCYTHE(2)	S AY TH
OBJECTS	AA B JH EH K T S
OBJECTS(2)	AH B JH EH K T S
LET	L EH T
SEPARATION	S EH P ER EY SH AH N
OTHERS	AH DH ER Z
DISSUADE	D IH S W EY D
SING	S IH NG
MISER	M AY Z ER
EXTREME	IH K S T R IY M
GREAT	G R EY T
BURTHENS	B AH R TH AH N Z
CONCEIT	K AH N S IY T
METRE	M IY T ER
LEAVING	L IY V IH NG
SURVEY	S ER V EY
DEFEAT	D IH F IY T
PROOF	P R UW F
MAKES	M EY K S
WRITES	R AY T S
COMPOSED	K AH M P OW Z D
THRALLED	TH R AO L D
CHASTE	CH EY S T
APPLE	AE P AH L
SIRE	S AY ER
FORBID	F ER B IH D
FORBID(2)	F AO B IH D
WIN	W IH N
WHOE'ER	W OW AH AH R
PRIVATE	P R AY V AH T
UPREAR	AH P R IHER
INSTINCT	IH N S T IH NG K T
WIT	W IH T
DECREASE	D IH K R IY S
DECREASE(2)	D IY K R IY S
SCANDAL	S K AE N D AH L
CLOUD	K L AW D
DESIRING	D IH Z AY ER IH NG
LOVERS'	L AH V ER Z
USE	Y UW S
USE(2)	Y UW Z
CHEERED	CH IH R D
FROM	F R AH M
REMAINS	R IH M EY N Z
REMAINS(2)	R IY M EY N Z
HAMMERED	HH AE M ER D
NEXT	N EH K S T
NEXT(2)	N EH K S
FEW	F Y UW
DOUBT	D AW T
THEMSELVES	DH EH M S EH L V Z
THEMSELVES(2)	DH AH M S EH L V Z
HIDING	HH AY D IH NG
SUN'S	S AH N Z
DEFENDANT	D IH F EH N D AH N T
CHEEKS	CH IY K S
POSSESSION	P AH Z EH SH AH N
PENCIL	P EH N S AH L
BABE	B EY B
PRETTY	P R IH T IY
MISUSE	M IH S Y UW Z
MISUSE(2)	M IH S Y UW S
FAMOUSED	F EY M AH S T
SAVAGE	S AE V AH JH
SAVAGE(2)	S AE V IH JH
HEIR	EH R
NEED'ST	N IY D S T
INFECTION	IH N F EH K SH AH N
INSUFFICIENCY	IH N S AH F IH SH AH N S IY
TATTERED	T AE T ER D
GLADLY	G L AE D L IY
HARVEST	HH AA R V AH S T
ANNOY	AH N OY
NONE'	N AH N
ACCOUNT	AH K AW N T
SALVING	S AA V IH NG
THIS	DH IH S
RIDE	R AY D
CROSSED	K R AO S T
PRAISE	P R EY Z
EXECUTOR	IH G Z EH K Y AH T ER
MEET	M IY T
DROPS	D R AA P S
BEFITS	B IH F IH T S
VAUNT	V AO N T
CONTROL	K AH N T R OW L
DREGS	D R EH G Z
UNSWEPT	AH N S W EH P T
GROW'ST	G R OW S T
USHERS	AH SH ER Z
PROCESS	P R AA S EH S
PROCESS(2)	P R AO S EH S
HIGH	HH AY
SOUGHT	S AO T
HIS	HH IH Z
SOMETHING	S AH M TH IH NG
BONES	B OW N Z
PURPOSED	P ER P AH S T
PAWS	P AO Z
DARKENING	D AA R K AH N IH NG
DARKENING(2)	D AA R K N IH NG
COUNTERFEIT	K AW N T ER F IH T
COUNTERFEIT(2)	K AW N ER F IH T
LAMB	L AE M
COMES	K AH M Z
COUNTING	K AW N T IH NG
COMPOUNDED	K AH M P AW N D AH D
COMPOUNDED(2)	K AH M P AW N D IH D
FALLS	F AO L Z
SIT	S IH T
SICKLE'S	S IH K AH L Z
HOLDS	HH OW L D Z
THRALL	TH R AO L
MOODS	M UW D Z
SWEAR	S W EH R
BEAMS	B IY M Z
MIGHTST	M AY T S T
FORSAKEN	F AO R S EY K AH N
SIN	S IH N
WATERY	W AO T ER IY
WATERY(2)	W AO T ERIY
ATTEND	AH T EH N D
WATCH	W AA CH
WATCH(2)	W AO CH
ANNEXED	AE N EH K S T
ANNEXED(2)	AH N EH K S T
CANKER	K AE NG K ER
ABUSE	AH B Y UW S
ABUSE(2)	AH B Y UW Z
FITS	F IH T S
WORTH'S	W ER TH S
TOMB	T UW M
PHYSIC	F AY Z AH K
BANKRUPT	B AE NG K R AH P T
UNTRIMMED	AH N T R IH M D
LIGHT	L AY T
LAME	L EY M
LINES	L AY N Z
CHIEF	CH IY F
WRIT	R IH T
ALLOW	AH L AW
TENURE	T EH N Y ER
FAVOURITES	F AE V AH R AY T S
DISPRAISE	D IH S P R EY Z
NEGLECT	N AH G L EH K T
NEGLECT(2)	N IH G L EH K T
BEAUTIES	B Y UW T IY Z
STAMPED	S T AE M P T
TRANSFIX	T R AE N S F IH K S
MOVE	M UW V
SIGHTLESS	S AY T L AH S
O'ERLOOK	AHAH R L AH K
VAINLY	V EY N L IY
WHILST	W AY L S T
BEGUILE	B IH G AY L
DEAREST	D IH R AH S T
ENCLOSE	IH N K L OW Z
LOOKS	L UH K S
TYRANT	T AY R AH N T
THYSELF	DH AY S EH L F
BADGES	B AE JH IH Z
PERFECT	P ER F EH K T
PERFECT(2)	P ER F IH K T
REFUSEST	R IH F Y UW Z AH S T
FRAILTIES	F R EY L T IY Z
BROOD	B R UW D
WHEREON	W EHER AO N
UNSTAINED	AH N S T EY N D
UNSTAINED(2)	AH N S T EY N ED
DECAY	D IH K EY
LO	L OW
WHEREOF	W EHER AH V
BANQUET	B AE NG K W AH T
THEMES	TH IY M Z
WILLING	W IH L IH NG
CHOOSE	CH UW Z
TICKLED	T IH K AH L D
GREATER	G R EY T ER
ANCHORED	AE NG K ER D
SWEETS	S W IY T S
STOUT	S T AW T
HANDS	HH AE N D Z
HANDS(2)	HH AE N Z
FRONT	F R AH N T
OWNER'S	OW N ER Z
KINDNESS	K AY N D N AH S
AFFECTIONS	AH F EH K SH AH N Z
DAY	D EY
DAMASKED	D AE M AE S K T
STRIVE	S T R AY V
PROFOUND	P R OW F AW N D
EASED	IY Z D
FEAST	F IY S T
MOUTHED	M AW DH D
MOUTHED(2)	M AW DH ED
TRIMMED	T R IH M D
SLIDE	S L AY D
TRUTH	T R UW TH
GAZING	G EY Z IH NG
LEGIONS	L IY JH AH N Z
TREADS	T R EH D Z
PITYING	P IH T IY IH NG
DOING	D UW IH NG
PRINCES'	P R IH N S AH Z
PRINCES'(2)	P R IH N S IH Z
ILLS	IH L Z
ALTERATION	AO L T ER EY SH AH N
SOCIETY	S OW S AY IH T IY
DECAYS	D AH K EY Z
EXCEEDED	IH K S IY D AH D
EXCEEDED(2)	IH K S IY D IH D
OUR	AW ER
OUR(2)	AW R
OUR(3)	AA R
BAY	B EY
TENTH	T EH N TH
BEWEEP	B IH W IY P
OUT	AW T
RESPECTS	R IH S P EH K T S
RESPECTS(2)	R IY S P EH K T S
RESPECTS(3)	R AH S P EH K S
RESPECTS(4)	R IY S P EH K S
CHILDREN'S	CH IH L D R AH N Z
PLODS	P L AA D Z
CONFESS	K AH N F EH S
SUFFICED	S AH F AY S T
BAD	B AE D
FROWNS	F R AW N Z
IMPART	IH M P AA R T
CAUSE	K AA Z
CAUSE(2)	K AO Z
RED	R EH D
MONUMENTS	M AA N Y AH M AH N T S
MONUMENTS(2)	M AA N Y UW M AH N T S
PERISH	P EH R IH SH
FRANK	F R AE NG K
WITHERING	W IH DH ER IH NG
DARKLY	D AA R K L IY
EMBASSY	EH M B AH S IY
ATTENDING	AH T EH N D IH NG
TIED	T AY D
THRUST	TH R AH S T
YORE	Y AO R
CURED	K Y UH R D
HER	HH ER
REARWARD	R IH ER W ER D
COULD	K UH D
KEEP	K IY P
COUNTERPART	K AW N T ER P AA R T
KEEN	K IY N
LENGTH	L EH NG K TH
LENGTH(2)	L EH NG TH
CURES	K Y UH R Z
MORTAL	M AO R T AH L
HENCE	HH EH N S
EARS	IH R Z
EARS(2)	IY R Z
RUDELY	R UW D L IY
FRAGRANT	F R EY G R AH N T
PITIED	P IH T IY D
POSSESSING	P AH Z EH S IH NG
POWERFUL	P AWER F AH L
LOVELINESS	L AH V L IY N AH S
FEASTS	F IY S T S
LEARNED'S	L ER N D Z
SUCH	S AH CH
REIGNED	R EY N D
QUALITY	K W AA L AH T IY
MOIETY	M OW AY AH T IY
UNEARED	AH N IH ER D
LOVE'	L AH V
SADLY	S AE D L IY
ORDERING	AO R D ER IH NG
DOVE	D AH V
DOVE(2)	D OW V
VULGAR	V AH L G ER
SEAT	S IY T
THEIR	DH EH R
INTELLIGENCE	IH N T EH L AH JH AH N S
PROUDER	P R AW D ER
TRAVELLED	T R AE V AH L D
BADNESS	B AE D N AH S
FAIREST	F EH R IH S T
PAINFUL	P EY N F AH L
LOW	L OW
SEALED	S IY L D
WERE'T	W EH R AH T
PERFORCE	P ER F AO R S
QUENCHED	K W EH N CH ED
PREFIGURING	P R IY F IH G Y ER IH NG
SPITES	S P AY T S
COMMENCE	K AH M EH N S
SOUNDLESS	S AW N D L AH S
STEEL	S T IY L
LOVED	L AH V D
UNLOOKED	AH N L UH K T
AUGHT	AO T
O'ER	OWER
RICHES	R IH CH AH Z
RICHES(2)	R IH CH IH Z
RICHER	R IH CH ER
BED	B EH D
JOLLITY	JH AA L AH T IY
TRANSGRESSION	T R AE N Z G R EH SH AH N
BODY'S	B AA D IY Z
LOVES	L AH V Z
LOVER	L AH V ER
DUMB	D AH M
LILY'S	L IH L IY Z
STEEP	S T IY P
DESCRIPTIONS	D IH S K R IH P SH AH N Z
VENGEFUL	V EH N JH F AH L
ACCUSING	AH K Y UW Z IH NG
ENFORCED	EH N F AO R S T
BEGGARED	B EH G ER D
FALSE	F AO L S
FORGET'ST	F AO R JH AH T S T
BEGGAR	B EH G ER
LABOURING	L EY B ER IH NG
GENTLY	JH EH N T L IY
REFIGURED	R IY F IH G Y ER D
GENTLE	JH EH N T AH L
GENTLE(2)	JH EH N AH L
BUY	B AY
TORMENT	T AO R M EH N T
HAVE	HH AE V
NEED	N IY D
TURN	T ER N
SINGS	S IH NG Z
BASTARD	B AE S T ER D
BOUGH	B AW
WITS	W IH T S
ABLE	EY B AH L
GRAVITY	G R AE V AH T IY
GRAVITY(2)	G R AE V IH T IY
ADJUNCT	AE JH AH NG K T
WHICH	W IH CH
WHICH(2)	HH W IH CH
DIVERT	D AY V ER T
DIVERT(2)	D IH V ER T
LILY	L IH L IY
ABHOR	AE B HH AO R
ADIEU	AH D UW
UNLESS	AH N L EH S
CENTRE	S EH N T ER
SENSES	S EH N S IH Z
WHO	HH UW
PRIVILAGE	P R AY V AH L AH JH
BEDS'	B EH D Z
TIME'S	T AY M Z
HARMFUL	HH AA R M F AH L
SNOWED	S N OW D
BUT	B AH T
PRISONER	P R IH Z AH N ER
PRISONER(2)	P R IH Z N ER
EXPIRED	IH K S P AY R D
WHY	W AY
WHY(2)	HH W AY
HUSBAND'S	HH AH Z B AH N D Z
AFRESH	AH F R EH SH
DENY	D IH N AY
WHEREWITH	W EHER W IH TH
BRED	B R EH D
STRONGER	S T R AO NG G ER
DISEASE	D IH Z IY Z
WIDOW'S	W IH D OW Z
PIPE	P AY P
WOUNDED	W UW N D IH D
PAINTING	P EY N T IH NG
PAINTING(2)	P EY N IH NG
OUTLIVE	AW T L IH V
DEFACE	D IH F EY S
IMPRESSION	IH M P R EH SH AH N
AFLOAT	AH F L OW T
WILFUL	W IH L F AH L
COULDST	K OWAH L D S T
BURDEN	B ER D AH N
POESY	P OW AH Z IY
BRING	B R IH NG
MANY'S	M EH N IY Z
ROUGH	R AH F
OBSEQUIOUS	AH B S IY K W IY AH S
DEBATE	D AH B EY T
SPURRING	S P ER IH NG
ENVY	EH N V IY
KNOWLEDGE	N AA L AH JH
KNOWLEDGE(2)	N AA L IH JH
CHIDING	CH AY D IH NG
PHILOMEL	F IH L AH M AH L
MUTE	M Y UW T
WOO	W UW
SHOULD	SH UH D
BASES	B EY S AH Z
BASES(2)	B EY S IH Z
BASES(3)	B EY S IY Z
PREPOSTEROUSLY	P R IH P AA S T AH R AH S L IY
PREPOSTEROUSLY(2)	P R IH P AA S T AHRAH S L IY
FUEL	F Y UW L
FUEL(2)	F Y UW AH L
MARRIAGE	M EH R IH JH
INHABIT	IH N HH AE B AH T
HOPE	HH OW P
MEANT	M EH N T
ACCESSARY	AE K S EH S EH R IY
DOUBTING	D AW T IH NG
MEANS	M IY N Z
FAMILIAR	F AH M IH L Y ER
BEAR	B EH R
PERFECTION	P ER F EH K SH AH N
WORDS	W ER D Z
DURST	D ER S T
LEASES	L IY S IH Z
SPUR	S P ER
OFFENCE'S	AH F EH N S IH Z
ENDLESS	EH N D L AH S
HERETIC	HH EH R AH T IH K
EVIDENT	EH V AH D AH N T
BRAIN	B R EY N
GUST	G AH S T
MARRIED	M EH R IY D
SUMMON	S AH M AH N
SHE	SH IY
CONTAIN	K AH N T EY N
FIXED	F IH K S T
VIEW	V Y UW
STRENGTHENED	S T R EH NG TH AH N D
SLUTTISH	S L AH T AH SH
UNTRUE	AH N T R UW
OUTBRAVES	AW T B R EY V Z
FARTHEST	F AA R DH AH S T
MISCALLED	M IH S K AO L D
FRAME	F R EY M
SHAKE	SH EY K
LEGACY	L EH G AH S IY
MERITS	M EH R AH T S
MERITS(2)	M EH R IH T S
CHANGES	CH EY N JH AH Z
CHANGES(2)	CH EY N JH IH Z
ENFEEBLED	EH N F IY B AH L D
VIOLET	V AY AH L IH T
SLEEPING	S L IY P IH NG
TRIPPING	T R IH P IH NG
ERROR	EH R ER
CLOSET	K L AA Z AH T
RECORD	R AH K AO R D
RECORD(2)	R EH K ER D
RECORD(3)	R IH K AO R D
PATTERN	P AE T ER N
VOWS	V AW Z
UNSEEING	AH N S IY IH NG
TEND	T EH N D
STATE	S T EY T
BOUGHS	B AW Z
PROGRESS	P R AA G R EH S
PROGRESS(2)	P R AH G R EH S
PROGRESS(3)	P R OW G R EH S
NEITHER	N IY DH ER
NEITHER(2)	N AY DH ER
BESMEARED	B IH S M IH ER D
WIRY	W IH R IY
DREADING	D R EH D IH NG
DATELESS	D EY T L AH S
DRESSINGS	D R EH S IH NG Z
JOY	JH OY
SORROW	S AA R OW
HOOKS	HH UH K S
KEY	K IY
PRECIOUS	P R EH SH AH S
WEARY	W IH R IY
SWIFT	S W IH F T
HITS	HH IH T S
FIGURED	F IH G Y ER D
INSTANT	IH N S T AH N T
LIMITS	L IH M AH T S
LIMITS(2)	L IH M IH T S
INVITED	IH N V AY T AH D
INVITED(2)	IH N V AY T IH D
THENCE	DH EH N S
EQUAL	IY K W AH L
MINDS	M AY N D Z
APRIL	EY P R AH L
ADMIT	AH D M IH T
DEVOUR	D IH V AW ER
STREAMS	S T R IY M Z
STORE'S	S T AO R Z
BEHAVIOUR	B IH HH EY V Y ER
CANOPY	K AE N AH P IY
LOFTY	L AO F T IY
KINDS	K AY N D Z
KINDS(2)	K AY N Z
GLORIOUS	G L AO R IY AH S
AYE	AY
COMMENT	K AA M EH N T
FESTER	F EH S T ER
MARJORAM	M AA R JH ER AE M
STATUES	S T AE CH UW Z
UNFOLDING	AH N F OW L D IH NG
WALK	W AO K
WALK(2)	W AA K
COMMEND	K AH M EH N D
BEGUILED	B IH G AY L D
TABLE	T EY B AH L
RENEWEST	R IY N UW AH S T
SECOND	S EH K AH N D
ADDITION	AH D IH SH AH N
WILLS	W IH L Z
DEVISE	D IH V AY Z
DEVISE(2)	D IH V AY S
WHATE'ER	W AA T AH AH R
SEASONED	S IY Z AH N D
CERTAIN	S ER T AH N
POET	P OW AH T
WASTE	W EY S T
DEFINE	D IH F AY N
TYRANNY	T IH R AH N IY
DESCRIBE	D IH S K R AY B
GENERAL	JH EH N ER AH L
GENERAL(2)	JH EH N R AH L
PROUDEST	P R AW D AH S T
LEAGUE	L IY G
PAINTED	P EY N T AH D
PAINTED(2)	P EY N T IH D
PAINTED(3)	P EY N AH D
PAINTED(4)	P EY N IH D
RELEASING	R IY L IY S IH NG
HEAR'ST	HH IY R S T
LETS	L EH T S
UNMOVED	AH N M UW V D
OVERTURN	OW V ER T ER N
PAINTER	P EY N T ER
PAINTER(2)	P EY N ER
DEBTOR	D EH T ER
NOVEL	N AA V AH L
SOURLY	S AW ER L IY
SOURLY(2)	S AWER L IY
WILT	W IH L T
PLAIN	P L EY N
APPEARANCE	AH P IH R AH N S
AS	AE Z
AS(2)	EH Z
WILL	W IH L
WILL(2)	W AH L
RIPER	R AY P ER
HATE'S	HH EY TS
AT	AE T
RIPE	R AY P
PHYSICIANS	F AH Z IH SH AH N Z
PHYSICIANS(2)	F IH Z IH SH AH N Z
ALMOST	AO L M OW S T
THUS	DH AH S
LASCIVIOUS	L AH S IH V IY AH S
LASCIVIOUS(2)	L AH S IH V IYAH S
HEARTED	HH AA R T AH D
HEARTED(2)	HH AA R T IH D
LAMBS	L AE M Z
SITS	S IH T S
HALT	HH AO L T
RANSOM	R AE N S AH M
PIED	P AY D
PERHAPS	P ER HH AE P S
CROSS	K R AO S
PROCEEDS	P R AH S IY D Z
PROCEEDS(2)	P R OW S IY D Z
LARGESS	L AA R JH AH S
ADVERSE	AE D V ER S
PARTS	P AA R T S
DUTEOUS	D Y UW T IY AH S
FREEZINGS	F R IY Z IH NG Z
PARTY	P AA R T IY
BLOOMS	B L UW M Z
SLAVE	S L EY V
FLESH	F L EH SH
SHAMES	SH EY M Z
LASTING	L AE S T IH NG
DRINK	D R IH NG K
UPON	AH P AA N
EFFECT	IH F EH K T
EFFECT(2)	IY F EH K T
EFFECT(3)	AH F EH K T
OUTCAST	AW T K AE S T
NIGHTLY	N AY T L IY
DECEMBER'S	D IH S EH M B ER Z
DUST	D AH S T
JUDGMENT	JH AH JH M AH N T
STEALS	S T IY L Z
AUDIT	AO D IH T
SCARCELY	S K EH R S L IY
OFF	AO F
I	AY
WHOLE	HH OW L
COLOUR	K AH L ER
WELL	W EH L
THOUGHT	TH AO T
AMENDS	AH M EH N D Z
OFT	AO F T
SETS	S EH T S
ARISING	ER AY Z IH NG
TWIRE	T W AY R
LEST	L EH S T
RESTORE	R IH S T AO R
FEATHERED	F EH DH ER D
STORES	S T AO R Z
KISS	K IH S
HEAVILY	HH EH V AH L IY
O'ERPRESSED	AHAH R P R AH S T
GULLS	G AH L Z
CRIES	K R AY Z
INTERIM	IH N T ER AH M
INTERIM(2)	IH N T R AH M
INTERIM(3)	IH N ER AH M
SKILL	S K IH L
THITHER	TH IH DH ER
DOST	D AA S T
RECKONING	R EH K AH N IH NG
RECKONING(2)	R EH K N IH NG
FIELD	F IY L D
ONWARD	AO N W ER D
SKY	S K AY
FLED	F L EH D
SIMPLE	S IH M P AH L
ADD	AE D
OTHER	AH DH ER
OTHER(2)	AHDHER
WET	W EH T
INFANT'S	IH N F AH N T S
RAVEN	R EY V AH N
WOOED	W UW D
FATE	F EY T
TESTY	T EH S T IY
DEVISED	D IH V AY Z D
FAMINE	F AE M AH N
WHO'S	HH UW Z
CRUSHED	K R AH SH T
SMOTHER	S M AH DH ER
SMOTHER(2)	S M AHDHER
FIVE	F AY V
KNOW	N OW
UNSEEN	AH N S IY N
PRESS	P R EH S
FOOLS	F UW L Z
LOSS	L AO S
SHOWING	SH OW IH NG
LIKE	L AY K
LOST	L AO S T
PERPETUAL	P ER P EH CH UW AH L
ADMITTED	AH D M IH T AH D
BESEECHERS	B IH S IY CH ER Z
HEED	HH IY D
LOSE	L UW Z
NERVES	N ER V Z
WORKS	W ER K S
SOFT	S AA F T
SOFT(2)	S AO F T
PAGE	P EY JH
LENDS	L EH N D Z
THEREIN	DH EH R IH N
DECEASE	D IH S IY S
EXCEED	IH K S IY D
INCONSTANT	IH N K AA N S T AH N T
WORKINGS	W ER K IH NG Z
THIEF	TH IY F
ALIVE	AH L AY V
IMMORTAL	IH M AO R T AH L
HAIR	HH EH R
GROWTH	G R OW TH
SPRINGS	S P R IH NG Z
SPRINGS(2)	S P ER IH NG Z
HOME	HH OW M
TRANSPORT	T R AE N S P AO R T
HEAVEN'S	HH EH V AH N Z
HEAVEN'S(2)	HH EHVAH N Z
LEAD	L EH D
LEAD(2)	L IY D
BROAD	B R AO D
LEAN	L IY N
LEAP	L IY P
FOUNTAIN	F AW N T AH N
PASSION	P AE SH AH N
MASKED	M AE S K T
O'ERTAKE	AAAH R T EY K
POETS	P OW AH T S
SLIGHT	S L AY T
DEATH'S	D EH TH S
HOW	HH AW
EXPIRE	IH K S P AY R
ALTHOUGH	AO L DH OW
WORTHY	W ER DH IY
POSTERITY	P AA S T EH R AH T IY
IMAGINARY	IH M AE JH AH N EH R IY
INSULTS	IH N S AH L T S
WORTHS	W ER TH S
STAGE	S T EY JH
ABOUT	AH B AW T
MURD'ROUS	M AH R D R AH S
RARE	R EH R
DUN	D AH N
LINGER	L IH NG G ER
LINGER(2)	L IH NG ER
FREEDOM	F R IY D AH M
HARDER	HH AA R D ER
BLESSINGS	B L EH S IH NG Z
GAINER	G EY N ER
HAIRS	HH EH R Z
TONGUE	T AH NG
BESHREW	B IH SH R UW
OUTSTRIPPED	AW T S T R IH P T
OWN	OW N
POLISHED	P AA L IH SH T
OWE	OW
ATTAINT	AE T EY N T
GUARD	G AA R D
PROMISE	P R AA M AH S
ESTEEM	EH S T IY M
FEMALE	F IY M EY L
LAWFUL	L AO F AH L
QUICKLY	K W IH K L IY
GAZETH	G EY Z IH TH
SUBORNED	S AH B AO R N D
FIRED	F AYER D
VICTORS	V IH K T ER Z
VEIL	V EY L
TRENCHES	T R EH N CH IH Z
WATCHMAN	W AA CH M AH N
SPREAD	S P R EH D
GRIEF'S	G R IY F S
FUNCTION	F AH NG K SH AH N
PROPHETIC	P R AH F EH T IH K
HOISTED	HH OY S T AH D
HOISTED(2)	HH OY S T IH D
BRAND	B R AE N D
INVOCATE	IH N V OW K AH T
FOUNTAINS	F AW N T AH N Z
GAIT	G EY T
PROPHECIES	P R AA F AH S IY Z
PLAGUE	P L EY G
GAIN	G EY N
DELIVERS	D IH L IH V ER Z
EAR	IY R
EAR(2)	IH R
EAT	IY T
BUD	B AH D
HE	HH IY
COUNT	K AW N T
MADE	M EY D
WISE	W AY Z
PRINCES	P R IH N S AH Z
PRINCES(2)	P R IH N S IH Z
GLORY	G L AO R IY
WHETHER	W EH DH ER
WHETHER(2)	HH W EH DH ER
WISH	W IH SH
GRIEVE	G R IY V
TRIUMPHANT	T R AY AH M F AH N T
EYES'	AY Z
PLACED	P L EY S T
CRUEL	K R UW L
CRUEL(2)	K R UW AH L
CONVERTED	K AH N V ER T IH D
LIMIT	L IH M AH T
MONUMENT	M AA N Y UW M AH N T
MONUMENT(2)	M AA N Y AH M AH N T
MINUTES	M IH N AH T S
BEARING	B EH R IH NG
RIGHTLY	R AY T L IY
DEATHS	D EH TH S
FRIEND'	F R EH N D
MEASURE	M EH ZH ER
DEARTH	D ER TH
DENOTE	D IH N OW T
GOODNESS	G UH D N AH S
GOODNESS(2)	G UH D N IH S
INK	IH NG K
FLEETING	F L IY T IH NG
NAMING	N EY M IH NG
ENDEARED	EH N D IY R D
NURSED	N ER S T
MUTUAL	M Y UW CH UW AH L
COMPARED	K AH M P EH R D
DIDST	D IH D S T
DRESSED	D R EH S T
BOOT	B UW T
FORESTS	F AO R AH S T S
DETAIN	D IH T EY N
SLUMBERS	S L AH M B ER Z
BOOK	B UH K
WITNESS	W IH T N AH S
SICK	S IH K
UNLETTERED	AH N L EH T ER D
BEHOLD	B IH HH OW L D
WHAT'S	W AH T S
WHAT'S(2)	HH W AH T S
THRIVERS	TH R AY V ER Z
SEMBLANCE	S EH M B L AH N S
STAR	S T AA R
OPPRESSION	AH P R EH SH AH N
VARIATION	V EH R IY EY SH AH N
STAY	S T EY
METHINKS	M EH TH AH NG K S
CHANCE	CH AE N S
QUIETUS	K W IY T AH S
EARTHLY	ER TH L IY
ASTRONOMY	AH S T R AA N AH M IY
FRIENDS	F R EH N D Z
TAN	T AE N
GHOST	G OW S T
STIRRED	S T ER D
RANKS	R AE NG K S
HE'S	HH IY Z
JEWEL	JH UW AH L
JEWEL(2)	JH UW L
PICTURED	P IH K CH ER D
PUPIL	P Y UW P AH L
SWAY'ST	S W EY S T
VASSAL	V AE S AH L
DETERMINATION	D IH T ER M AH N EY SH AH N
ACCIDENTS	AE K S AH D AH N T S
GARDENS	G AA R D AH N Z
